京温跳楼事件|Jingwen jumping events
袁利亚离奇死亡|Yuan Liya died mysteriously
现场大秀|Live big show
觉行之路|Sense line of the road
hz上海|Hz Shanghai
禅风|Zen
聚心堂|Poly Coeur
辰华集团|Chen Hua Group
企业联合会|Enterprise Confederation
两善|Two good
公民互爱|Citizen mutual love
企业家联谊会|Entrepreneurs Association
《生命的本质》|"Essence of life"
《社会契约论》|"Social Contract"
www . bχχ3.сoм|WW. BΧΧ3.сoм
赌风暴疾|Gambling storm illness
反通|Anti-pass
撑粤语|Support Cantonese
办警察证qq|Office police certificate QQ
警官证办理qq|Jing Guanzheng handle QQ
文凭代办qq|Diploma agent QQ
001-416 -361 -9895|
001 -888 -892 -8757|
1 -888 -892 -8757|
文凭代办网|Diploma agency network
001-510 -372 -0176|
001-866-697-6570|
702 -873 -1734|
001 -626 -457 -8037|
freegate one|Freegate one
threewithdrawals|ThreeWithdrawals
真相画刊|Truth Illustrated
zhenxianghuakan|Zhenxianghuakan
占领中南海|Occupy Zhongnanhai
淫秽电影在线|Pornographic movies online
同性恋服务|Gay Service
文凭代办|Diploma agency
警官证办理|Jing Guanzheng handle
办警察证|Do police certificate
办警官证|Do Jing Guanzheng
伊斯兰祈祷团|Jemaah Islamiyah
伊斯兰圣战|Islamic Jihad
新疆恐怖组织|Xinjiang terrorist organization
新疆恐怖份子|Xinjiang terrorists
新疆恐怖分子|Xinjiang terrorists
新疆恐怖分子|Xinjiang terrorists
催情香水|Aphrodisiac perfume
逼毛|Forced Mao
b毛|B Gross
成人视频|Adult Video
成人视频|Adult Video
成人电影|Adult Movies
插b|Insert B
插b|Insert B
插逼|Insert force
乳子|Milk child
舔b|Lick B
舔逼|Lick force
性交|Hardcore
性交|Hardcore
性交|Hardcore
乳交|Tit
摸奶|Touch milk
摸奶|Touch milk
轮奸|Gang rape
b喷水|B water
逼喷水|Forced water
壮阳药|Aphrodisiac
视屏脱衣|Screen strip
左爱艹b|Left love Lv b
黄色歪1|Yellow crooked 1
想看秀的|To see the show
插入骚穴|Insert Saoxue
最新源码看片|Latest source to see the film
看漺片去|Kanshuangpianqu
大秀q群|Big show Q group
堵红包|Block red
赌红包|Bet red
点击群视频进入|Click on the video to enter the group
看大秀|See the big show
走私群|Smuggling group
文爱群|File Aiqun
bb喷水|BB spray
成人影片|Adult Video
东北人偷井盖|Northeast stealing manhole covers
河南人偷井盖|Henan stolen covers
看比加|Look Pekah
成人av电影|Adult AV Movie
真人秀加|Reality TV plus
点看a片|A sheet point of view
看姐自慰|Watch sister masturbating
大锈日片|Large stainless sheet date
小妹脱衣|Young girl undressing
脱衣视频|Strip video
免费聊寂寞|Free chat lonely
大秀激情|Big show of passion
美女视频服务|Beauty Video Services
色男加我|Color man add me
女自蔚|Women from Wei
丝袜裸聊|Stockings nude chat
少妇被干片|Young woman is dry sheet
课聊服务|Lesson chat service
裸聊网站|Nude chat site
收费聊天|Charges Chat
收费聊天|Charges Chat
骚妹加q|Sao sister plus Q
视频裸聊|Nude video chat
性女爽|Of female Shuang
加妹看脱|Plus sister to see off
自慰加q|Masturbation plus Q
色男课聊|Color M class chat
网操加q|Net operating plus Q
寂寞加妹妹|Lonely plus sister
出售黄盘|For Sale yellow plate
１v１捰|1V1 Luo
1对1果聊|1 to 1 fruit chat
１对１粿|1 to 1 cake
１对１倮|1 to 1 Luo
1对1视频表演|1 to 1 video show
１对１衤果辽|1 to 1 Yi Liao fruit
360毛片|360 Maopian
av成人|Av adult
av出售|AV Sale
av大片|AV tracts
av福利|AV welfare
av加微信|AV plus micro-Letter
av加薇信|AV Jiawei letter
av色片|AV color film
av网盘|AV network disk
av微信|AV micro-channel
av小视频|AV small video
av云盘|AV cloud disk
av在线|AV Online
av专卖|AV Monopoly
av资源|AV resources
a片q群|A piece Q Group
a片电影|A feature film
a片加q|A piece plus Q
a片扣扣|A piece buttoned
a片网|A piece of mesh
a片要的加|A sheet to the plus
a片在线|A piece Online
bb喷水|Bb water
ｂ锈美乳|B rust Breasts
e情云盘|E emotion cloud disk
kan美乳q|Kan Q Breasts
lo聊加|Lo chat plus
lu0聊|LU0 chat
luo×女|Luo × female
luo辽|Luo Liaoning
ｌｕｏ钕视频|Luo neodymium video
l聊qq|L QQ chat
papa网盘|Papa network disk
papa云盘|Papa cloud disk
papa芸盘|Papa Yun disc
qq大秀群|QQ big show group
q果聊|Q fruit chat
w部a片|W section A piece
yun盘q|Yun plate Q
yun盘你懂的|Yun dish you know
爱爱视频|House of Love video
爱爱微信|House of Love micro-channel
逼逼激情|Force force of passion
逼逼喷水|Force force jet
操b自慰|Options B masturbation
仯妇寂寞|Miao lonely woman
成年人电影|Adult Movies
成人av|Adult AV
成人av|Adult AV
成人黄色|Adult yellow
成人毛片|Adult Maopian
成人网盘|Adult network disk
成人网站|Adult Sites
成人云盘|Adult cloud disk
成人做爱|Adult sex
承接裸秀演艺|Undertake bare Show Performing Arts
出售av|For Sale av
出售黄片|Sale of pornographic films
出售黄片种子|Sale of pornographic films seed
打飞机看女|Planes look female
打飞鸡q|Hit fly chicken Q
大飞机q|Large Aircraft Q
大秀qq|Big show QQ
大秀yy群|Big show YY group
大秀y群|Big show Y group
大秀表演|Big show performances
大秀服务|Big show services
大秀加q|Big show plus q
大秀卖逼女|Big show of force women to sell
大秀群|Big show group
大秀速度进|Speed ​​into the big show
大秀想看|Want to see the big show
大秀直播|Big show live
带你看有大秀|Take you to see a big show
单独走私|Smuggling alone
岛国大片|Large island
岛国啪啪|Island flap
岛国网盘|Island network disk
岛国想看加|Island to see plus
低价包射|Low packet radio
電影芸盘|Movie Yun disc
東京熱电影|Tokyo hot movie
東京熱電影|Tokyo hot movie
—薱—表演|- Dui - Performance
粉逼薇芯|Powder forced Wei core
高潮妹|Climax sister
高清av|HD AV
给你大秀|Give you a big show
购买a片|Buy A piece
国产啪啪|Domestic pops
果聊q|Fruit chat Q
果聊加扣|If additional deduction chat
果聊加微信|Fruit plus micro-channel chat
果聊微信|If the micro-channel chat
猓聊|Guo chat
猓聊妹q|Q Mei Guo chat
粿妞|Cake girl
粿籹脫|Cake cake off
粿秀|Cake show
粿秀小妹|Cake sister show
黑丝、抠β|Black silk, pull β
黑丝美足|Black silk beauty Foot
黑丝美足视频|Heisi US Foot Video
黑丝诱惑包射|Black silk temptation to pack shot
狠狠撸最新网址|Bitter blow your latest URL
皇片|Wong sheet
皇色云盘|Huangseyunpan
黄片加微信|Yellow sheet plus micro letter
黄色a片|A yellow sheet
黄色网站|Pornographic websites
黄色网址|Yellow Website
黄色云盘|Yellow cloud disk
黄网永久看|Yellow net permanent watch
黄云盘片|Huang disc
簧片秀逼|Reed show force
簧色大片|Color blockbuster spring
激情插逼|Passion plug force
激情你懂的|Passion you know
激情视屏|Passion Screen
激情做爱|Passion sex
激晴电影|Shock Partly movie
寂寞lo聊|Lonely LO chat
寂寞仯妇|Lonely Miao women
寂寞男加q|Lonely male plus Q
寂寞男加我|Lonely man add me
寂寞男人加|Lonely man plus
寂寞骚女|Sao lonely woman
寂寞熟女ｑ|Lonely MILF Q
寂寞寻做爱|Lonely find love
寂寞找老公|Find lonely husband
寂寞找佬公|Lonely guy looking male
寂寞找娚人|Lonely people looking for Nan
加q看裸照|Add Q to see nude
加我看裸|Plus I see nude
加我看脱|Add me off
加我微信看坐爱|Plus I love to sit watching the micro-letter
加走私q|Add smuggling Q
枧屏粿料|Jianpinghualiao
噭啨電影|Qiaoqing movie
精彩璜图|Juan FIG wonderful
开始看大秀|Began to see the big show
看(月兑)衣舞|See  clothing dance
看@片扣|Look @ piece buckle
看av加|Look Av plus
看av加qq|See AV plus QQ
看a片加|See A piece plus
看bb喷水|Look BB spray
看b加q|See B plus Q
看b加v信|See B plus V letter
看da秀|Look Da Show
看se加微信|Look se plus micro letter
看逼逼加|Kanbibijia
看逼加我|Look forced to add my
看大眯眯q|Look Great Mimi q
看大片啪啪|To see a large flap
看大秀qq|See the big show qq
看大秀加|See the big show plus
看大秀来|See the big show to
看惈聊|See Guo chat
看黄q|Look Huang Q
看黄加|Look Huang
看黄片的加|Watch pornographic films plus
看黄片加|Watch pornographic films plus
看黄微信|See yellow micro letter
看黃片|Watch pornographic films
看簧q|Look Reed Q
看簧片|Look Reed
看簧片加|Look Reed plus
看巨乳|Watch Busty
看抠b|Look pull B
看裸加|Look bare plus
看裸加q|Look bare plus Q
看毛片加|Kan Maopian plus
看毛片进|Kan Maopian feed
看美乳|Look Breasts
看美腿q|Look legs q
看妹脱光|Look sister naked
看妹子逼|Look sister force
看男女啪啪|See men and women pops
看片聊骚|See the film chat show
看搔女|Look scratch Women
看色视频|Look-color video
看丝袜美腿|Look Legs
看拖衣服|Look drag clothes
看脫衣舞|Look striptease
看脱衣|Look undressing
看脱衣加|Look strip plus
看秀撸|See the show lu
看秀舞群|See the show dancers
看绣加微信|Look embroidery plus micro letter
看最新裸照|See the latest nude
课聊qq|Lesson QQ chat
课聊加|Lesson chat plus
空间ａ片|A piece of space
空间有a|A space
抠b秀|Pull B show
扣q自慰|Buckle Q masturbation
扣逼钕q|Buckle force neodymium Q
囖柳|Lo Liu
撸管神器|Line and pipe artifact
镥管q|Lutetium tube q
啰ホ夘|La ホ Wan
啰窷|La Liao
罗聊|Luo chat
罗秀騷女|Luoxiu Sao Women
镙体看射|Look Luo body shot
螺汝|Lo Ru
螺秀表演|Lo show performances
倮服务|Luo Service
倮辽|Luo Liao
倮聊|Luo chat
倮女ｑ|Luo female Q
倮女qq|Luo female QQ
倮釹|Luo neodymium
裸1聊文爱|Bare a chat message love
裸liao|Bare Liao
裸ｑ|Bare Q
裸t秀|Naked T show
裸辽|Bare Liao
裸疗|Naked Therapy
裸疗一对一视频|Bare one video treatment
裸撩|Bare tease
裸撩加|Bare tease plus
裸撩加q|Bare tease plus q
裸漏妹|Drain bare sister
裸妹妹扣|Naked sister buckle
裸妹试看|Look naked girl
裸妹一元一分钟|Naked girl one yuan one minute
裸妹在线|Naked girl online
裸妹真人|Naked girl live
裸妞|Naked girl
裸妞表演|Naked girl show
裸妞脱秀|Naked girl show off
裸妞一对一|Naked girl one
裸女qq|Nude qq
裸女大秀|Nude big show
裸钕|Bare neodymium
裸钕一对一|Neodymium bare one
裸釹|Bare neodymium
裸銫女|Naked female cesium
裸玩表演|Naked play performances
裸秀q|Naked show q
裸秀表演|Naked show performances
裸秀女|Naked show girls
裸秀诱惑|Naked show Temptation
裸锈|Bare rust
裸照视频|Nude video
躶妞服务|Luo girl service
攞栁|Luoliu
洛聊|Los chat
摞聊|Pile chat
摞聊|Pile chat
摞绣表演|Pile embroidery show
摞照观奶约炮|Luozhaoguannai about gun
买黄云|Buy Huang
买云盘q|Buy cloud dish Q
毛片q|Q Maopian
毛片网|Feather Network
毛片微信|Maopian micro letter
毛片云盘|Feather cloud disk
每晚看大秀|See the big show every night
美眉脱光|Crush strip
美女１对１视频|Beauty 1 to 1 video
美女大秀|Beauty big show
美女裸料|Beauty bare feed
美女全脱q|Beauty all off Q
美女全脱加|Beauty all off plus
美女视频秀|Beauty Video Show
美女視频加|Beauty video plus
美女脱衣|Beauty strip
美女自慰|Beauty Masturbation
美乳骚妹|Sao sister Breasts
美足诱惑|United States Foot Temptation
妹给你爽|Sister give you cool
妹裸表演|Sister naked performers
妹躶扣|Mei Luo buckle
妹啪电影|Sister snapped Movies
妹全脱|Sister all off
妹托光扣|Meituoguangkou
妹想约炮|Sister think about guns
妹子给你爽|Sister give you cool
妹子陪你玩喷水|Sister to accompany you to play water
妹自抠|Sister from pull
免费果聊|Free fruit chat
免费猓聊|Free Guo chat
免费黄片|Free porn
免费看簧|Free watch spring
免费少钕逼|Free little neodymium force
免费丝袜聊|Free Stockings chat
摸扎逼逼|Mozhabibi
拿床上电影|Take the bed Movie
男撸管加|M line and pipe plus
男人福利微信|Man Welfare micro letter
男人你懂q|Man you know Q
侽人電影|Nan man movie
侽朲電萾|Nanrendianying
莮人電影|Nan man movie
内湿骚女|Sao inside wet woman
内湿透骚女|o drenched female> within
内湿小骚女|Small show within wet woman
嫩b想草|B want to tender grass
钕脱|Neodymium off
啪啪av电影|Pops AV Movie
啪啪yun盘|Pops Yun disc
啪啪y盘|Pops Y plate
啪啪电影|Pops movie
啪啪盘v信|Flap disc V letter
啪啪视频|Pops Video
啪啪网盘|Pops network disk
啪啪微信|Pops micro letter
啪啪云盘|Pops cloud disk
啪啪芸盘|Yun tray pops
啪啪雲盘|Pops cloud disk
怕啪➪店影|Afraid snapped ➪ shop Movies
怕啪芸盘|Papayunpan
怕怕微信|Horrifying micro letter
怕怕影盘|Horrifying video disc
怕怕云盘|Horrifying cloud disk
喷水妹q|Sprinkler sister Q
全裸服务|Naked Service
全裸紧逼|Naked tight
让你高潮|Let you climax
搔女求加|Women seeking scratch plus
骚b服务|Sao B Services
骚q女|Sao Q Female
骚妹高潮秀|Sao climax sister show
骚妹黑丝|Sao black silk sister
骚妹艳舞|Sao sister Rouge
骚妞|Sao girl
骚女ｑ|Sao Female q
骚女qq|Sao Female qq
骚女电话|Sao Female Phone
骚女服务|Sao waitress
骚女加|Sao female plus
骚女加v信|Sao female plus V letter
骚女扣|Sao female buckle
骚女陪聊|Sao woman chatting
骚女求曰|Sao said women seeking
骚女脱内裤|Sao female underwear off
骚女脱衣|Sao woman undressing
骚女微信|Sao female micro-channel
骚女找男|Saonvzhaonan
騒妹大秀|Uproar sister big show
騒妹漏q|Uproar sister drain Q
騒妹绣逼|Saomeixiubi
色女b水流|B Female color flow
色女qq|Color female QQ
色女看片|Color woman watch films
色女视频|Color Female Video
色女水多多|Color female water lot
色钕一对一|Color neodymium-one
色情电影|Porn Movies
色情电影|Porn Movies
色情露逼|Porn Lu force
色色网盘|Color color network disk
涩情电影|Shibuya Love Movie
铯情电影|Cesium Love Movie
少妇扣逼|Young woman forced to buckle
深夜交友威信|Dating prestige night
视频l聊|Video L chat
视频表演q|Videos show Q
视频大秀|Video big show
视频短片微信|Video clips micro letter
视频福务加|Video blessing service plus
视频果聊|Video Fruit chat
视频秀女|Videos show women
视频诱惑加|Video temptation to add
視頻服務q|Video Services q
收费l聊|Charges L talk
收费看大秀|Charges see the big show
收费妹子自拍|Charges sister Self
手机爽片|Phone cool piece
售360云盘|Sale 360 ​​cloud disk
售av片|The sale of AV sheet
售啪怕啪|Sale snapped snapped fear
售云盘q|Sale cloud dish Q
爽来加妹|To add cool girl
丝袜逼逼秀|Stockings force to force the show
丝袜扣屄|Stockings buckle cunt
丝袜露逼|Stockings Lucy force
丝袜妹激情服务|Stockings sister Passion Service
丝袜热舞q|Stockings dance Q
丝袜视频|Pantyhose Video
送a片|A sheet feeding
婷婷脫表演|Tingting show off
凸依舞|Convex according to dance
禿衣舞加|Tuyiwujia
托光扣|Prop light buckle
托衣q|Q clothing care
托依舞|Prop according to dance
拖衣妹妹|Drag clothes sister
脫锈|Off rust
脫演q|Q play off
脫衣惈舞|Guo strip dance
脫依诚信一对一|According to the integrity of one-off
脱光表演|Strip show
脱光服务|Stripped Service
脱光视频|Naked video
脱光玩嫩逼|Play tender naked force
脱玩表演|Play show off
脱秀q|Q show off
脱秀表演|Off show performances
脱衣表演|Strip show
脱衣加q|Strip plus Q
脱衣微信|Strip micro-channel
脱衣舞|Striptease
脱衣舞表演|Striptease
脱衣秀|Strip show
玩逼喷水|Play force jet
婉婷服务q|Q Wanting service
万部av|Ten thousand av
万部成人|Ten thousand adults
万部黄片|Ten thousand pornographic films
万部色片|Ten thousand color film
万部网盘|Ten thousand network disk
万部云盘|Ten thousand cloud disk
网盘大片|Large network disk
网盘黄片|Network disk porn
网盘万部|000 unit network disk
微信av|Micro letter av
捰聊|Luo chat
捰窷|Woliao
捰钕|Luo neodymium
捰玩ｑ|Luo play Q
捰秀小妹|Show Luo Xiaomei
无码毛片|Uncensored Maopian
午夜大秀|Midnight big show
午夜挩衣|Midnight Yan Yi
想妹子服务加|Want sister service plus
小电影加威信|Small movie Algarve letter
信誉裸秀|Credit naked show
性感玩逼|Sexy force play
羞b羞乳裸|B shame shame naked breast
羞钕抠ｂ|Shame neodymium pull B
羞钕脱光|Neodymium naked shame
秀b美乳|Show B Breasts
秀女qq|QQ show women
需要av的加|Need av plus
需要课聊|Need Lesson chat
艳射舞|Yan dance radio
要课聊加|Add to class to talk
一对一裹聊|One wrapped chat
一对一粿|One cake
一对一裸|One naked
一对一视频|One video
一对一视屏聊|One screen chat
一对一视屛|One visual Ping
一对一脱衣|One strip
一夜情加|One Night Stand plus
忧货汝|Worry cargo Ru
有裸聊的吗|Do have nude chat
约炮q|About guns Q
约炮的请加|About guns, please add
约炮加q|About gun plus Q
约炮加我|Add me about gun
约炮群|About Baoqun
云盘av专卖|Cloud AV disc Monopoly
云盘v片|Cloud sheet tray v
云盘电影|Cloud disc movie
云盘加q|Cloud dish plus Q
云盘美女电影|Cloud Beauty movie disc
云盘啪啪|Cloud tray pops
云盘万部|000 cloud disk unit
云盘-微信|Cloud plate - micro letter
云盘做爱电影|Cloud disk sex movie
在线看av|Online see AV
在线裸汝|Online bare Ru
在线裸舞|Online nude dancing
在线钕|Online neodymium
在线骚妹|Online show girl
找寂寞娚|Find lonely Nan
找小姐加|Find Miss plus
真人大秀|Real big show
制服一对一|Uniform one
种子云盘|Seed cloud disk
主播大秀|Anchor big show
自拍视频加微信|Profile video plus micro letter
自拍自慰|Self-masturbation
走私qq|Smuggling QQ
走私表演|Performance smuggling
走私视频|Smuggling Video
最新成~人~网|Latest into ~ people ~ network
最新簧片|Latest Reed
做爱a片|A piece sex
做爱加|Sex plus
做爱视频|Sex video
主播奶子|Anchor Boobs
小穴|small hole 
小穴|small hole 
成人脱|Adult off
处女y片|Virgin Y piece
001 -800 -546 -4518|
001-626-457-8037|
黄色歪|Yellow crooked
贾晓晔|Jia Xiaoye
被判處無期|Was sentenced to an indefinite period
被判处无期|Sentenced to an indefinite period 
一审无期徒刑|The first trial to life imprisonment
中共政治局|Politburo
权钱帝国|Imperial power and money
周xx|Zhou xx
一审被判无期|Sentenced to life in prison in the first trial 
周灏|Zhou Hao
温青山|Wen Qingshan
丁雪峰|Ding Xuefeng
蒋洁敏|Jiang Jiemin
山西帮|Shanxi Clique
石油帮|Oil clique
权钱、权色交易|Power-money, power-sex trade
国法红线|The red line of the state law
無期徒刑|life imprisonment
洩露國家秘密|Leaking state secrets
濫用職權|Abuse of power
賈曉曄|Jia Xiaoye
周濱|Zhou Bin
周滨|Zhou Bin
epochtimes  中共|Epochtimes CPC
epochtimes"九评|Epochtimes "Nine Commentaries
epochtimes"中共|Epochtimes "CCP
gardennetworks"epochtimes|Gardennetworks "epochtimes
tuidang"epochtimes|Tuidang "epochtimes
tuidang@epochtimes|Tuidang @ epochtimes
江氏独裁"中共|Jiang's dictatorship "CCP
裁判嘴长菊花上|Referee mouth long chrysanthemum
10元=900qb|10 yuan = 900QB
10元10万lol|10 yuan 100,000 lol
棵liao加妹|Trees liao plus sister
epochtimes|Epochtimes
soundofhope|Soundofhope
党内分歧|Inner-party differences
讲法录像|Lecture Recording
江氏独裁|Jiang's dictatorship
大法简介|Dafa Introduction
迫害新唐人|Persecution NTDTV
新唐人"反迫害|NTDTV "Persecution
新唐人"退党|NTDTV 'resignations
001-604-276-2569|001-604-276-2569
001 -818 -338 -2883|0.01 -818-338-2883
001-201-625-6301|001-201-625-6301
001-702-248-0599|001-702-248-0599
secretchina"看中国|Secret China
secretchina中共|Secretchina CPC
selfip"secretchina"ncn|Selfip "secretchina" ncn
动态网最新地址|Dynaweb latest address
揭露中共 迫害|Expose the CCP's persecution
迫害真相调查|Investigation on Persecution
武警"大纪元|Armed "Epoch
无界网络|Unbounded Network
如意搜索|Ruyi Search
揭露中共|Expose the CCP
林轻舟"看中国|Forest Adventure "See China
赵子法报导|Zhao Zifa
中国 零八宪章|Chinese Charter 08
零八宪章 签名|Signature of Charter 08
冲向会场|Rushed to the venue
6700亿|670000000000
30亿工程|3 billion project
「红烧兔子」大餐|"Braised rabbit" feast
虐待中国妇女的|Abused Chinese women
天下蒙古人|World Mongols
叶城喀什|Kashgar City, Yecheng County
删帖|Delete posts
五十名中将|Fifty in
50名中将|50 in
江蛤蛤|River clam clams
关于真理|About Truth
巨大的成功|A huge success
ωωω．sьь3．cοm|Ωωω. sЬЬ3. cοm
挖眼角膜|Dig cornea
国家人权行动|National Human Rights Action
共匪荼毒|Communist poison
打倒共匪|Down with the CCP bandits
零八宪章|Charter 08
零八宪章|Charter 08
「红烧兔子」|"Braised rabbit."
我出钱你炒股|I pay you stocks
线上配资|Online with capital
无需证券开户|No securities account
创新融资工具|Innovative financing tools
股票配资|Shares with capital
看阴道加|Look vaginal plus
aъсъъκ|
艾青“逆子”|Ai Qing "inverse"
自由与人权斗士|Freedom and human rights fighters
《老妈蹄花》|"Mom Ti Hua"
公民调查|Citizen Survey
kickstarter|KickStarter
艾未未沙尘暴|Ai Weiwei Sandstorm
杰森·维什诺|Jason Wei Shennuo
艾#未未|Ai Weiwei #
艾未未|Ai Weiwei
jason wishnow|Jason Wishnow
人权斗士|Human rights fighters
维什诺|Wei Shennuo
水贩子|Water traffickers
杜可风|Doyle
艾未来|Ai Future
yyfuzhu|YyFuZhu
yy直播出事| yy live accident
忘关视频被啪|forgot to turn off the video while having sex
忘记关视频被啪|forgot to turn off the video while having sex
yy出事视频| yy accident video
yy不雅视频| YY indecent video
主播不雅视频| Anchor indecent video
بۇلۇتلۇق ھاۋا|cloudy weather
نەرسىلەر ياخشى|good things
بار يەردە توي پالانچى|wedding place
ياخشى سودا|good business/trade
زۇكام يۇقۇملۇق|contagious flue
يېتىش بالنىستا|stay in hospital
باشقۇرۇش بازار|market management
قۇغۇنى قۇمۇل|Komul's sweet mellon 
ياڭيۇ تاتلىق|sweet potato
دىگەن سالاي كۆۋرۈك|hope to build a bridge
mahpi|secret
qurultay|congress
qurultay|congress
kurultay|congress
kurultay|congress
kurulteyi|congress
kurax|
kurex|
istiklal|victory
istiqlal|victory
hokomiti|
hokomat|
hukumat|
tashkilat|
teshkilat|
teshkilat|
مۇناپىق|traitor
قادىر رابىيە|Rebiya Kadeer
كوممۇنىست|communist
ئىسلام ئاۋازى|voice of Islam
تاھىر يۇلداشە|Tahi Yoldashov/f
qural|weapon
kural|weapon
تۈركىستان|Dogu/East Turkestan
ئەبۇ زەيد|Abu Zayd
پارتلىتىش|blow up/explosion
تاجاۋۇز|invasion
tajawuz|
tajawuz|
ئابدۇللاھ مەنسۇر|Abdullah Mensur
مۇجاھىد|mujahid
azatqi|
mujahid|
mujahid|
xinjiang terrorist|
بىن لادىن|Bin Laden
bin ladin|
jihadtexkilat|
terrori|Terror
terrorist|Terrorist 
terorist|Terrorist 
بازار ەشكىلاتىەلقائىدە تەشكىلاتىئ|Bazaar Teshkilatelqaide/organization of rule
ئۆزبېكىستان ئىسلام ھەركىتى|Turkestan Islamic Movement
وگۇ تۈركىستان|Dogu/East Turkestan
تۈركىستان  ئىسلام پار تىيىسى|Turkestan Islam Party
كاپىر|non-believer
جىھاد|jihad
partila|explode
partla|explode
jehat|jihad
jahad|jihad
jahad|jihad
ixit|dog
amut|pear
كامىرا|camera
دوختۇر|doctor
ئىت|dog
داۋالىنىش|get treatment
شىپاخانا|clinic
دوختۇرخانا|hospital
ئەمىر|leader
كىنىشكە|card
دەپتەر|notebook
ھاۋانچا|a mortar
تۇربا|pipe
ياڭاق|walnut
گۈرۈچ|rice
نەشپۈت|pear
ئامۇت|pear
سەۋزە|carrots
پىياز|onion
چامغۇر|turnip
emir|leader
emir|leader
mehpi|secret
jihat|jihad
jihat|jihad
texkilat|organization
texkilat|organization
taxkilat|organization
taxkilat|organization
hitay|Chinese
hitay|Chinese
خىتاي|Chinese
硝基脲炸药|Nitrourea explosives
特屈儿炸药|Special flexor children explosives
三硝基苯甲硝胺|Three tetryl
硝酸肼|Hydrazine nitrate
硝酸盐炸药|Nitrate explosives
硝酸盐炸药|Nitrate explosives
漂白剂炸弹|Bleach bomb
漂白剂炸弹|Bleach bomb
硝化棉炸药|Nitrocellulose explosives
引爆系统|Detonation system
硝酸甘油炸药|Nitroglycerin dynamite
铝热炸弹|Thermite bomb
无锈蚀击发药|No rust firing drug
无锈蚀击发药|No rust firing drug
无雷汞击发药|No Leigong firing drug
白糖炸弹|Sugar bomb
白糖炸弹|Sugar bomb
高压锅炸弹|Pressure cooker bomb
高压锅炸弹|Pressure cooker bomb
简易定时炸弹|Easy Time Bomb
简易空气炮|Simple air cannon
化肥炸弹|Fertilizer bomb
干冰炸弹|Dry Ice Bomb
干冰炸弹|Dry Ice Bomb
黄色炸药苦味酸|TNT picric
雷汞炸药|Leigong explosives
碎片式地雷|Fragmented mines
制作地雷|Create mines
出售地雷|For Sale mines
爆炸式地雷|Explosive mines
黑梯铝炸药|Black aluminum ladder explosives
黑梯铝炸药|Black aluminum ladder explosives
粉笔炸弹|Chalk bomb
粉笔炸弹|Chalk bomb
奥克托今|HMX
奥克托今|HMX
气狗v信|Air Dog v letter
气狗威信|Air Dog prestige
汽狗威信|Steam dog prestige
汽狗v信|Steam dog v letter
硝糖烟雾弹|Glass Sugar smoke bomb
硝糖烟雾弹|Glass Sugar smoke bomb
简易爆炸装置|Improvised explosive devices
简易爆炸装置|Improvised explosive devices
鸡尾酒炸弹|Cocktail bomb
爆炸箭头|Exploding arrows
爆炸箭头|Exploding arrows
汽油燃烧弹|Gasoline incendiary
凝固汽油弹|Napalm
泡沫聚苯乙烯|Styrofoam
硝酸肼液体|Hydrazine nitrate liquid
硝酸肼液体|Hydrazine nitrate liquid
硝酸肼镍|Nickel hydrazine nitrate
太恩炸药|Well too explosive
太恩炸药|Well too explosive
淘宝刷销量|Taobao brush sales
淘宝刷流量|Taobao brush flow
刷信誉|Brush credibility
淘宝刷单|Taobao Scalping
淘宝兼职|Taobao part timer 
网上兼职|Online part
网络兼职|Network part-time
刷好评|Brush praise
淘宝放单|Taobao release a single
网络电视软件|Internet TV software
网络电视机顶盒|Network TV set-top boxes
电视棒|TV Stick
电视棒|TV Stick
网络视频收集器|Network video collector
刘源|Liu Yuan
3400亿|340000000000
38军|38 army
金色艺术团|Golden Troupe
黄之峰|Wong Chi-fung
影视棒|TV stick
jabhat|Jabhat 
345194446|
ss2676|
割头视频|Cutting Head Video
残忍割头|Cruel Cutting Head
割喉斩首|Cutthroat beheading
باريس_تشتعل|Paris Burns 
18688894409|
13580457144|
刷销量|click farming
假币销售|Counterfeit sales
精仿假币|Fine imitation of counterfeit money
军品弩刀|Military crossbow knife
刀弩军刺|Knife Crossbow Shanker
刀，弩|Knife, crossbow
刀弩＋q|Knife crossbow + q
刀弩q|Knife Crossbow q
刀弩+q|Knife crossbow + q
ow吸毒被抓|ow, took drugs, was arrested
磕p视频|P knock Video
تەجەللىي|Tejellih
شۈكىروف|Shukirof
弓弩军刺|Crossbow Shanker
aldinki|Aldinki
sada005|Sada005
详情+qq群|Details + QQ group
清华大学教授|Professor of Tsinghua University
做单佣金|Do a single commission
推荐费|Referral Fee
假聊|False talk
返现返款|Cash back rebate
五區公投|Five district referendum
公投制憲|Constitutional Referendum
普羅政治學苑|Proletariat Political Institute
鄭錦滿|Cheng Kam-mun
鄭松泰|Cheng Chung-tai
黃洋達|Wong Yeung-tat
黃之鋒|Wong Chi-fung
komünist|Communist
cemaati’nden|the community
cihad|Jihad
partiyasi|Party
katlediyor|slaughtering
vahşice|savagely
müslüman|Muslim
inşallah|God willing
doğu|East
cemaati|Community
点艹韩雅|Point Fuck Han Ya
六合彩|Lottery
六合彩|Lottery
新疆籍劫匪|Xinjiang membership robbers
法论大法|Falun Dafa
反革命集团|Counterrevolutionary group
二月逆流|February countercurrent
革命大批判|Revolutionary mass criticism
反革命政变|Counterrevolutionary coup
反击右倾翻案风|Counterattack the Right-Deviationist Reversal-of-Verdicts Trend
全面反思派|Full Reflection School
重新评价派| Re-evaluation of school
民粹主义者|Populist
批林批孔|Criticize Lin , Criticize Confucius 
派性斗争| Factional struggle
修正主义| Revisionism
新华门|Xinhua Gate
文革信徒|Cultural Revolution believers
反思文革|Reflections on Cultural Revolution
cultural revolution|
文革复辟|Restoration of the Cultural Revolution
红歌晚会|red song gala
十日文革|Ten days of the Cultural Revolution
文化大革命|Cultural Revolution
文化大革命|Cultural Revolution
文革底片|Cultural Revolution film
紅色青年|Red Youth 
李振盛| Li Zhensheng
苗德顺|Miao Deshun 
文革遗产|Cultural Revolution Legacy
共匪|CPC bandits
共匪|CPC bandits
共产流氓|Communist hooligans
暴政掠夺|Tyranny plunder
南京郵電大學|Nanjing University of Posts and Telecommunications
翻牆軟件|Software over the wall
shadowsocks|Shadowsocks
專制統治|Dictatorship
一黨獨裁|One-party dictatorship
团派干部|Tuanpai PERSONNEL
朱镕基|Zhu Rongji
朱镕基|Zhu Rongji
习平衡|Xi balance
各方派系|Factional parties
和平变革|Peaceful change
宪政变革|Constitutional Reform
习皇|Xi Emperor
五一六通知|May 16 Notification
李崇威|Lichong Wei
香港中国笔会|Hong Kong Chinese PEN
红歌演唱会|Red Song Concert
文革| Cultural Revolution
文革余孽|Remnants of the Cultural Revolution
文革平反|Vindication of the Cultural Revolution
吾尔开希|Wuerkaixi
吾尔开希|Wuerkaixi
吴君梅|Wu Junmei
6·4英烈|6.4 martyrs
耀邦紫阳| Yaobang,  Ziyang
张国忠|Zhang Guozhong
于世文|Yu Shiwen
郭飛雄|Guo Feixiong
郭飞雄|Guo Feixiong
悼念64|64 memorial
64之殇|Deaths of 64
64万岁|64 Viva
64文化祭|64 Culture Festival
64文化传播|64 Cultural Communication
64学生坦克|64 students tanks
64伤痛历史|64 pain history
64动百度乱|64 moving Baidu chaos
64事变|64 Incident
64纪念|64 Memorial
64信息|64 Information
64怀念|64 memorials
怀念64|Miss 64
缅怀64|64 recall
平反64|64 rehabilitated
勿忘64|Do not forget 64
64大屠杀|64 massacre
89年64|89 64
64戒严|64 martial law
64惨案|64 tragedy
64学运|64 student movement
64屠杀|64 massacre
64真相|64 Truth
64tiananmen|64tiananmen
南北院之争|North-South School Debate
⑥④|⑥④
木樨地|Muxidi 
木樨地大屠杀|Muxidi massacre
大。法。好|Falun. Dafa. Good.
大。发。好|Falun. Dafa. Good.
文.革|cultural revolution
平反六四|Vindication of June 4
支聯會|Hong Kong Alliance in Support of Patriotic Democratic Movements in China
香港大学生会|The Hong Kong University Students' Union
支連会|Hong Kong Alliance in Support of Patriotic Democratic Movements in China
尖沙嘴|Tsim Sha Tsui
尖沙咀|Tsim Sha Tsui
維園|Victoria Park
燭光|Candlelight
六四平反|June 4 vindication
六四事件|June 4 Incident
六四 北京|June 4 Beijing
六四 八九|June 4 89
六四 军队|June 4 army
六四 胡耀邦|June 4 Hu Yaobang
六四 民主|June 4 Democracy
六四 绝食|June 4 hunger strike
六四 纪念|June 4 Memorial
六四 香港|June 4 Hong Kong
64事件|64 events
64 北京|64 Beijing
64 八九|64 89
64 军队|64 army
64 胡耀邦|64 Hu Yaobang
64 民主|64 democracy
64 绝食|64 hunger strike
64 纪念|64 Memorial
64 香港|64 Hong Kong
八九 学潮|89 Student strike
一九89|1989
八九 北京|89 Beijing
八九 军队|89 Army
八九 胡耀邦|89 Hu Yaobang
八九 民主|89 Democarcy
八九 绝食|89 Hunger strike
八九 纪念|89 Memorial
八九 香港|88 Hong Kong
89 北京|89 Beijing
89 军队|89 army
89 胡耀邦|89 Hu Yaobang
89 民主|89 democracy
89 绝食|89 Hunger strike
89 纪念|89 Memorial
89 香港|89 Hong Kong
89八平方|89 square of 8
北京 政治风波|Beijing political storm
北京 27年|Beijing 27 years
北京 血腥|Beijing bloody
木樨地 纪念|Muxidi Memorials
天安门 黑衫|Tiananmen Blackshirts
天安门 清场|Tiananmen clearance
广场 坦克|Square tank
天安门妈妈|Tiananmen mothers
北京 黑衫|Beijing Blackshirts
港人 游行|Hong Kong parade
寻找 王维林|Looking for Wang Weilin
郭飞雄 公开信|Guo Feixiong open letter
民主风筝|Democratic Kites
唐荆陵 绝食| Tang Jingling hunger strike
张善光 学生| Student Zhang Shanguang
倾斜的天安门|Tilt Tiananmen
贞洁的眼神|Chaste eyes
徐彩虹 被捕|Xu Caihong arrested
六四期间|June 4 period
六四 学生|June 4 student
89 64|8964
六四 坦克|June 4 tank
六四 赵紫阳|June 4 Zhao Ziyang
六四 政府|June 4 government
六四 示威|June 4 demonstration
六四 悼念|June 4 tribute
六四 重返|June 4 return
64期间|64 period
64 学生|64 students
64 殇|64 death
64 坦克|64 tanks
64 赵紫阳|64 Zhao Ziyang
64 政府|64 government
64 示威|64 demonstrators
64 悼念|64 memorial
64 重返|64 return
八九事件|89 event
19八九|1989
八九 学生|89 student
八九 坦克|89 tank
八九 赵紫阳|89 Zhao Ziyang
八九 政府|89 government
八九 示威|89  demonstrations
八九 悼念|89 memorial
八九 重返|89 return
89 学生|89 student
89 坦克|89 tank
89 赵紫阳|89 Zhao Ziyang
89 政府|89 government
89 示威|89 demonstration
89 悼念|89 memorial
89 重返|89 return
89viiv|89VIIV
春夏之交 风波|Political turmoil between the Spring and Summer
北京 二十七年|Beijing twenty-seven years
39军 进京|39th Group Army Enter Beijing
木樨地 蜡烛|Muxidi Candle
天安门 散步|Tiananmen Walking
天安门 重返| To return to Tiananmen Square
广场 屠杀|Square massacre
天安门 受难| Tiananmen Crucifixion
占领 天安门|Occupied Tiananmen Square
维园 晚会|Victoria Park Virgil
杜宪 新闻联播|Du Xian Xinwen Lianbo
郭飞雄 张青|Guo Feixiong Zhang Qing
推土机 种花|Blooms of Darkness
周锋锁 真相|Zhou Fengsuo Truth
李勇 捐款|Li Yong donation
盛雪 推特|Shengxue Twitter
王丹 贴纸|Wang Dan Stickers
白衬衫 散步|White shirt walking
5月35日|May 35
六四 平反|June 4 Vindication
六四 天安门|June 4 Tiananmen
六四 拖拉机|June 4 tractor
六四 腐败|June 4 corruption
六四 座谈|June 4 discussion
六四 静坐|June 4 sit still
六四 黑衫|June 4 blackshirt
六四 街头|June 4 street
64 惨案|64 tragedy
64 平反|64 vindication
64 天安门|64 Tiananmen
64 拖拉机|64 tractor
64 腐败|64 corruption
64 座谈|64 discussion
64 静坐|64 sit still
64 黑衫|64 Blackshirts
64 街头|64 streets
八九风波|89 turmoil
八九 平反|89 vindication
八九 天安门|89 Tiananmen
八九 拖拉机|89 trator
八九 腐败|89 corruption
八九 座谈|89 discussion
八九 静坐|89 sit still
八九 黑衫|89 blackshirts
八九 街头|89 street
89 天安门|89 Tiananmen
89 拖拉机|89 tractor
89 腐败|89 corruption
89 座谈|89 discussion
89 静坐|89 sit still
89 黑衫|89 Blackshirts
89 街头|89 streets
89 屠杀|89 massacre
北京 游行|Beijing parade
北京 平反|Beijing Vindication
北京 坦克人| Beijing tank person
蜡烛 没了|Candle is gone 
天安门 镇压|Tiananmen crackdown
天安门 回忆|Tiananmen memories
广场 拖拉机| Square tractor
六四 烛光|June 4 candlelight
维园 烛光|Victoria Park candlelight
温云超|Wen Yunchao
郭飞雄 维权|Guo Feixiong Rights Defense
民主女神 台湾|Taiwan Goddess of Democracy
封从德|Feng congde
尤维洁| You Weijie
chimerica|Chimerica
张先玲 母亲|Zhang Xianling mother
谭作人 疫苗|Tan Zuoren vaccine
六四 申遗|June 4 inscription
六四 二十七年|June 4 twenty-seven years
六四 镇压|June 4 crackdown
六四 血腥|June 4 bloody
六四 社论|June 4 editorial
六四 游行|June 4 parade
六四 血衣|June 4 Blood pants
六四 反思|June 4 reflection
64风波|64 turmoil
64 二十七年|64 twenty-seven years
64 镇压|64 crackdown
64 血腥|64 bloody
64 社论|64 Editorials
64 游行|64 parade
64 血衣|64 Blood pants
64 反思|64 Reflection
八酒六四|eight wine June 4
八九 27年|89 27 years
八九 镇压|89 repression
八九 血腥|89 bloody
八九 社论|89 editorial
八九 游行|89 parade
八九 血衣|89 Blood pants
八九 反思|89 reflection
89 镇压|89 crackdown
89 血腥|89 bloody
89 社论|89 Editorials
89 游行|89 parade
89 血衣|89 blood shirt
89 反思|89 Reflection
八九 屠杀|89 massacre
北京 学运|Beijing student movement
北京 镇压|Beijing crackdown
北京事件| Beijing Event
蜡烛 没收|Candle confiscation
北京 屠城| Beijing massacre
拖拉机 天安门|Tractor Tiananmen
天安门 敏感词|Tiananmen sensitive words
寻找 坦克|Looking for tanks
坦克 白衬衫| Tank white shirt
赵威 狱中|Zhao Wei prison
特朗普 六四|Trump June 4
玫瑰团队|Rose Team
郭宝胜 被捕|Guo Baosheng arrested
张永宁 t恤|Zhang Yongning T-shirt
费良勇 德国|Fei Liangyong Germany
赫建 采访|Hao Jian Interview
邓丽君 舞台剧|Deng Lijun Stage Play
六四 学潮|June 4 student strike
六四 27年|June 4 27 years
六四 遇难|June 4 victim
六四 邓小平|June 4 Deng Xiaoping
六四 中共|June 4 CCP
六四 39军|June 4 39th Group Army
六四 清场|June 4 clearance
六四 呼吁|June 4 advocate
陆4|Land 4
64 学潮|64 Student Strike
64 27年|64 27 Years
64 遇难|64 victims
64 邓小平|64 Deng Xiaoping
64 中共|64 Chinese Communist Party
64 39军|64 39th Group Army
64 清场|64 clearance
64 呼吁|64 advocate
八的平方|Square of 8
捌玖年|89 year
八九 二十七年|89 twenty-seven years
八九 遇难|89 victims
八九 邓小平|89 Deng Xiaoping
八九 中共|89 Chinese Communist party
八九 39军|89 39th Group Army
八九 清场|89 clearance
八九 呼吁|89 advocate
八九 屠城|89 massacre
89 遇难|89 victims
89 邓小平|89 Deng Xiaoping
89 中共|89 Chinese Communist Party
89 39军|89 39th Group Army
89 清场|89 clearance
89 呼吁|89 advocate
89之光|light of 89
89爱国运动|89 Patriotic Movement
北京 学潮|Beijing student movement
北京 清场| Beijing Clearance
北京 学生领袖|Beijing student leaders
木樨地甩站|Muxidi Subway Station 
天安门 血|Tiananmen blood
天安门 27年|Tiananmen Square 27 years
天安门母亲|Tiananmen Mothers
毋忘六四|Never Forget June 4
六四 无日无之|June 4 almost every day
符海陆|Fu Hailu
考拉 狱中|Koala prison
川普 六四|Trump June 4
于世文 绝食|Yu Shiwen hunger strike
徐琳 歌曲| Xu Lin songs
张永宁 纪念| Zhang Yongning Memorial
王策 西班牙|Wang Ce Spain
徐彩虹 北京|Xu Caihong Beijing
绿叶行动| Green Leaf action
六四北京|June 4 Beijing
六四八九|June 4 89
六四军队|June 4 army
六四胡耀邦|June 4 Hu Yaobang
六四民主|June 4 democracy
六四绝食|June 4 hunger strike
六四纪念|June 4 memorial
六四香港|June 4 Hong Kong
64北京|64 Beijing
64八九|64 89
64军队|64 army
64胡耀邦|64 Hu Yaobang
64民主|64 democracy
64绝食|64 hunger strike
64香港|64 Hong Kong
八九学潮|89 student strike
八九北京|89 Beijing
八九军队|89 army
八九胡耀邦|89 Hu Yaobang
八九民主|89 democracy
八九绝食|89 hunger strike
八九纪念|89 memorial
八九香港|89 Hong Kong
89北京|89 Beijing
89军队|89 army
89胡耀邦|89 Hu Yaobang
89民主|89 democracy
89绝食|89 hunger strike
89纪念|89 Memorial
89香港|89 Hong Kong
北京政治风波|Beijing political storm
北京27年|Beijing 27 years
北京血腥|Beijing bloody
木樨地纪念|Muxidi Memorials
天安门黑衫|Tiananmen Blackshirts
天安门清场|Tiananmen clearance
广场坦克|Square tank
北京黑衫| Beijing Blackshirts
港人游行|Hong Kong parade
寻找王维林|Looking For Wang Weilin
郭飞雄公开信|Guo Feixiong open letter
唐荆陵绝食|Tang Jingling hunger strike
张善光学生|Student Zhang Shanguang
徐彩虹被捕| Xu Caihong arrested
六四学生|June 4 student
8964|
8964|
六四坦克|June 4 tank
六四赵紫阳|June 4 Zhao Ziyang
六四政府|June 4 government
六四示威|June 4 demostration
六四悼念|June 4 memorial
六四重返|June 4 return
64学生|64 students
64殇|64 death
64坦克|64 tanks
64赵紫阳|64 Zhao Ziyang
64政府|64 government
64示威|64 demonstrators
64悼念|64 demostration
64重返|64 return
八九学生|89 student
八九坦克|89 tank
八九赵紫阳|89 Zhao Ziyang
八九政府|89 government
八九示威|89 demostration
八九悼念|89 memorial
八九重返|89 return
89学生|89 students
89坦克|89 tanks
89赵紫阳|89 Zhao Ziyang
89政府|89 government
89示威|89 demonstrators
89悼念|89 memorial
89重返|89 return
春夏之交风波|turmoil between spring and summer
北京二十七年|Beijing twenty-seven years
39军进京|39th Group Army enter Beijing
木樨地蜡烛|Muxidi Candle
天安门散步| Tiananmen Walking
天安门重返| To return to Tiananmen Square
广场屠杀| Square massacre
天安门受难|Tiananmen Crucifixion
占领天安门|Occupy Tiananmen Square
维园晚会| Victoria Park show
杜宪新闻联播|Du Xian Xinwen Lianbo
郭飞雄张青|Guo Feixiong Zhang Qing
推土机种花|Blooms of Darkness
周锋锁真相|Zhou Fengsuo Truth
李勇捐款|Li Yong Contributions
盛雪推特|Sheng Xue tweets
王丹贴纸|Wang Dan Stickers
白衬衫散步|White shirt walking
六四天安门|June 4 Tiananmen
六四拖拉机|June 4 tractor
六四腐败|June 4 corruption
六四座谈|June 4 discussion
六四静坐|June 4 sit still
六四黑衫|June 4 blackshirt
六四街头|June 4 street
64平反|64 vindication
64天安门|64 Tiananmen
64拖拉机|64 tractor
64腐败|64 corruption
64座谈|64 discussion
64静坐|64 sit still
64黑衫|64 Blackshirts
64街头|64 streets
八九平反|89 vindication
八九天安门|89 Tiananmen
八九拖拉机|89 tractor
八九腐败|89 corruption
八九座谈|89 discussion
八九静坐|89 sit still
八九黑衫|89 blackshirts
八九街头|89 street
89天安门|89 Tiananmen
89拖拉机|89 tractor
89腐败|89 corruption
89座谈|89 discussion
89静坐|89 sit still
89黑衫|89 Blackshirts
89街头|89 streets
89屠杀|89 massacre
北京游行|Beijing parade
北京平反|Beijing vindication
北京坦克人|Beijing tanks person
蜡烛没了|Candle is gone
天安门镇压|Tiananmen crackdown
天安门回忆|Tiananmen memories
广场拖拉机|Square tractor
六四烛光|Sixty-four candlelight
维园烛光|Victoria Park candlelight
郭飞雄维权|Activist Guo Feixiong
民主女神台湾|Taiwan Goddess of Democracy
张先玲母亲|Zhang Xianling mother
谭作人疫苗|Tan Zuoren vaccine
六四申遗|June 4 inscription
六四二十七年|June 4 twenty-seven years
六四镇压|June 4 crackdown
六四血腥|June 4 bloody
六四社论|June 4 editorial
六四游行|June 4 parade
六四血衣|June 4 blood shirt
六四反思|June 4 reflection
64二十七年|64 twenty-seven years
64镇压|64 crackdown
64血腥|64 bloody
64社论|64 Editorials
64游行|64 parade
64血衣|64 pants
64反思|64 Reflection
八九27年|89 27 years
八九镇压|89 repression
八九血腥|89 bloody
八九社论|89 editorial
八九游行|89 parade
八九血衣|89 blood shirt
八九反思|89 reflection
89镇压|89 crackdown
89血腥|89 bloody
89社论|89 Editorials
89游行|89 parade
89血衣|89 blood shirt
89反思|89 Reflection
八九屠杀|89 massacre
北京学运|Beijing student movement
北京镇压| Beijing crackdown
蜡烛没收|Candle confiscation
北京屠城| Beijing massacre
天安门二十七年|Tiananmen twenty-seven years
拖拉机天安门|Tractor Tiananmen
天安门敏感词|Tiananmen sensitive words
寻找坦克| Looking for tanks
坦克白衬衫|Tank white shirt
赵威狱中| Zhao Wei prison
特朗普六四|Trump June 4
郭宝胜被捕|Guo Baosheng arrested
张永宁t恤|Zhang Yongning T-shirt
费良勇德国|Fei Liangyong Germany
赫建采访|Hao Jian Interview
邓丽君舞台剧|Deng Lijun Stage Play
六四学潮|June 4 student strike
六四27年|June 4 27 years
六四遇难|June 4 victims
六四邓小平|June 4 Deng Xiaoping
六四中共|June 4 Chinese Communist Party
六四39军|sixty-four 39th Group Army
六四清场|June 4 clearance
六四呼吁|June 4 advocate
64学潮|64 Student Strike
6427年|June 4 27 years
64遇难|64 victims
64邓小平|64 Deng Xiaoping
64中共|64 Chinese Communist Party
6439军|64 39th Group Army
64清场|64 clearance
64呼吁|64 advocate
八九二十七年|89 twenty-seven years
八九遇难|89 victims
八九邓小平|89 Deng Xiaoping
八九中共|89 Chinese Communist party
八九39军|89 39th Group Army
八九清场|89 clearance
八九呼吁|89 advocate
八九屠城|89 massacre
89遇难|89 victims
89邓小平|89 Deng Xiaoping
89中共|89 CPC
8939军|89 39th Group Army
89清场|89 clearance
89呼吁|89 advocate
北京学潮|Beijing student movement
北京清场|Beijing Clearance
北京学生领袖|Beijing student leaders
天安门血|Tiananmen blood
天安门27年|Tiananmen Square 27 years
六四无日无之|June 4 almost every day
考拉狱中|Koala prison
川普六四|Trump June 4
于世文绝食|Wen world hunger
徐琳歌曲|Xu Lin songs
张永宁纪念| Zhang Yongning Memorial
王策西班牙|Wang Ce Spain
徐彩虹北京|Xu Caihong Beijing
六四|Six Four
六四|Six Four
六四|Six Four
大花猫捕狗药|Tabby Cat catch drug dog
闹狗药|Trouble drug dog
毒狗箭|Dog poison arrow
毒狗丸|Dog poison pill
毒狗针|Dog poison needle
氯化琥珀胆碱|Succinylcholine chloride
平近习|Xi Jinping
林祖銮|Lin Zulian
林祖戀|Lin Zulian
還我書記|Return our secretary
林荣基|Lam Wing Kee
天國樂團|Tian Guo Marching Band
天国乐团|Tian Guo Marching Band
彭丽媛|Peng Liyuan
彭丽媛|Peng Liyuan
彭丽媛|Peng Liyuan
彭麻麻|Peng Ma Ma
中央 习|Central Xi
习大大|Uncle Xi or Big Daddy Xi
习大大|Uncle Xi or Big Daddy Xi
刁近乎|Diao Jinhu
全歼菲方空军|Wipe out the Philippine Air Force
习总的拒绝|President Xi's rejection
中央政治局|Central Poliburo
快手号|Kuai Shou ID
快手id|Kuai Shou ID
快手呺|Kuai Shou ID
映客|Ying Ke
快手|Kuai Shou
陌陌|Momo
六间房|Six Room
六间房|Six Room
网易bobo|Netease BOBO
腾讯直播|Tencent Live
qq空间直播|QQ Space Live
花样直播|Hua Yang Live
繁星|Fan Xing
奇秀|Qi Xiu
酷我|Ku Wo
秀色|Xiu Se
kk直播|KK Live
红磨坊|Moulin Rouge
17173|
69直播|69 Live
火山直播|Huo Shan Live
美拍直播|Mei Pai Live
阿里星球|Ali Planet
熊猫tv|Panda TV
全民tv|Quanmin Live
龙珠直播|Long Zhu Live
股票资源网|Stocks News
草榴网|Caoliu
工字牌气枪官网|Jeans brand airguns official website
guaji9158|Guaji9158
担保平台|Guarantee platform
爆款刷单|click farming
军区参谋长|Military Chief of Staff
国务院|State Council
中央领导人|Central Leaders
中共中央|CPC Central Committee
滿屏盡是習寬衣|Screen bomboarded with Xi Undress
習寬衣|Xi Undress
省用足財|Reduce Cost, Accumulate Wealth. 
懋穡勸分|Work Hard, Help Each Other.
衣帶漸寬終不悔|My Clothes Grow More Loose Daily, Yet Care I Not. 
輕關易盜|Lower Taxation, Maintain Roads.
通商寬驛|Facilitate Commerce and Loosen Stations
同商寬衣|Same Commerce, Loosen Clothing
寬衣解帶|loosen the clothing and undo the tie/belt/girdle
放寬農政|loosen regulations on agricultural policies
通商寬nong|facilitate commerce and be lenient to nong 
通商寬yi|Facilitate Commerce and Loosen Clothing
通商寬農新成語|New Idiom of "Facilitate Commerce and Be Lenient to Farmers"
習主席用典|President Xi Allusions
初中生解衣|Junior high school students undress
做生意脫衣服|Do Business, Strip clothes.
维卡币|OneCoin
狠货代理|Ruthless cargo agent
俞正声|Yu Zhengsheng
郭声琨|Guo Shengkun
李克强|Li Keqiang
李克强|Li Keqiang
李克强|Li Keqiang
孟建柱|Meng Jianzhu
中央军军委|Army Central Military Commission
东突厥斯坦|East Turkestan
东突厥斯坦|East Turkestan
大毛拉教义|Maulana doctrine
大毛拉教义|Maulana doctrine
伊斯兰之声|Sound Islam
伊斯兰之声|Sound Islam
伊斯兰之声|Sound Islam
公道来了|justice has arrived
公道来了|justice has arrived
奸诈走了|Treacherous go
奸诈走了|Treacherous go
突厥斯坦|Turkestan
突厥斯坦|Turkestan
大毛拉|Maulana
大毛拉|Maulana
魔鬼的朋友战斗|Devil's friend fighting
魔鬼的朋友战斗|Devil's friend fighting
我们的道路|Our roads
我们的道路|Our roads
有教益故事|Instructive story
有教益故事|Instructive story
卡菲尔|Kafir
卡菲尔|Kafir
穆斯林|Muslim
穆斯林|Muslim
宗教解释|Religious explanations
宗教解释|Religious explanations
周永康|Zhou Yongkang
周永康|Zhou Yongkang
周永康|Zhou Yongkang
薄熙来|Bo Xilai
薄熙来|Bo Xilai
薄熙来|Bo Xilai
徐才厚|Xu Caihou
徐才厚|Xu Caihou
徐才厚|Xu Caihou
令计划|Ling Jihua
令计划|Ling Jihua
郭伯雄|Guo Boxiong
郭伯雄|Guo Boxiong
郭伯雄|Guo Boxiong
恶搞领袖|Spoof leaders
恶搞领袖|Spoof leaders
麻痹哥|Paralysis brother
麻痹哥|Paralysis brother
戴建勇|Dai Jianyong
戴建勇|Dai Jianyong
习达姆|Xi Dam
习达姆|Xi Dam
土鼠年和平革命|Earth Rat peaceful revolution
土鼠年和平革命|Earth Rat peaceful revolution
西藏简史|A Brief History of Tibet
西藏简史|A Brief History of Tibet
freeing tibet|Freeing tibet
freeing tibet|Freeing tibet
天葬|sky burial 
天葬|sky burial 
黄祸|Peril
黄祸|Peril
tibetan buddhism|Tibetan buddhism
tibetan buddhism|Tibetan buddhism
救救拉萨|Save Lhasa
救救拉萨|Save Lhasa
自由人心路|Free man mentality
自由人心路|Free man mentality
劝解合集|Persuasion Collection
天堂恋人|Lovers Paradise
天堂恋人|Lovers Paradise
天堂恋人|Lovers Paradise
东突穆斯林|East Turkistan Muslim
东突穆斯林|East Turkistan Muslim
圣战者|Mujahideen
圣战者|Mujahideen
宗教的劝告|Religion advice
迁徙者|Migrants
江系老军头|Jiang's old army head
江系老军头|Jiang's old army head
格丹央金措姆|Li Xiaolin's alleged religious name
江系大老虎|Jiang's tigers
一朝忽觉京梦醒|Once the vision is sometimes wake up in Beijing
邓小平篡权|Deng Xiaoping usurper
走资派邓小平|capitalist roader Deng Xiaoping
走资派邓小平|capitalist roader Deng Xiaoping
学生运动|Student Movement
学生运动|Student Movement
学生运动|Student Movement
包子心狠手辣|Buns ruthless
包子心狠手辣|Buns ruthless
处女进贡|Virgin tribute
侣行|On The Road
侣行|On The Road
e租宝|Ezubao
e租宝|Ezubao
e租宝|Ezubao
e租宝|Ezubao
租宝|Ezubao
租宝|Ezubao
e 租宝|Ezubao
e 租宝|Ezubao
e 租 宝|Ezubao
e 租 宝|Ezubao
e 租宝|Ezubao
e 租宝|Ezubao
e 租 宝|Ezubao
e 租 宝|Ezubao
易租宝|Yi Zu Bao
易租宝|Yi Zu Bao
fx气皇|fx gas Wong
fx气皇|fx gas Wong
gamo竞技之王|Gamo king of athletics
秃鹰膛线管|Vultures rifled tube
秃鹰狗|Condor dog
秃鹰狗|Condor dog
秃鹰狗|Condor dog
工字牌qb19|Workers plates QB19
秃鹰汽长狗|Vultures steam long dog
秃鹰汽长狗|Vultures steam long dog
仿真长狗|Simulation of Long Dog
仿真长狗|Simulation of Long Dog
短狗|Short Dog
特级运动长弹|Extra long projectile motion
特级运动长弹|Extra long projectile motion
花山n306|Huashan N306
花山n306|Huashan N306
m4a1|M4A1
柯尔特1911|Colt 1911
狗配件|Dog Accessories
狗配件|Dog Accessories
大口径pcp|Large caliber PCP
大口径pcp|Large caliber PCP
瓦尔特统治者|Walter ruler
l新型火箭|L new rocket
金钟汽枪|Admiralty Motor Gun
金钟汽枪|Admiralty Motor Gun
金钟气狗|Admiralty gas dog
金钟气狗|Admiralty gas dog
秃鹰图纸|Vulture drawing
秃鹰图纸|Vulture drawing
瑞典fx|Sweden fx
瑞典fx|Sweden fx
猎枪弹|Shotgun shells
猎枪弹|Shotgun shells
秃鹰配件|Vulture Accessories
秃鹰配件|Vulture Accessories
西德ks316|West Germany ks316
654k气枪|654K airgun
654k气枪|654K airgun
92式手狗|92 type hand dog
92式手狗|92 type hand dog
77式手狗|77 type hand dog
77式手狗|77 type hand dog
77式手枪|77 pistol
77式手枪|77 pistol
654k手枪|654k pistol
654k手枪|654k pistol
45mm铅弹|45MM pellet
45mm铅弹|45MM pellet
45mm狗粮|45MM Food
45mm狗粮|45MM Food
三角牌气枪|Triangle airgun
三角牌气枪|Triangle airgun
汽手狗|Steam Hand Dog
54式手枪|54 pistol
54式手枪|54 pistol
手拉狙|Hand spy
手拉狙|Hand spy
海豹m9|Seals M9
进口气狗|Dogs imported gas
进口气狗|Dogs imported gas
进口气狗|Dogs imported gas
运动枪|Sports Guns
运动枪|Sports Guns
韩国叛逆者|Korea traitor
土制炸弹|IEDs
土制炸弹|IEDs
土制手榴弹|Homemade grenade
土制手榴弹|Homemade grenade
土制手雷|Homemade grenades
土制手雷|Homemade grenades
起爆药|Primary Explosive
起爆药|Primary Explosive
塑胶炸药|Plastic explosive
塑胶炸药|Plastic explosive
自制炸药|Homemade explosives
自制炸药|Homemade explosives
c4橡胶炸药|C4 explosives rubber
c4橡胶炸药|C4 explosives rubber
土制火药|Home-made gunpowder
土制火药|Home-made gunpowder
土制火药|Home-made gunpowder
土制燃烧弹|Home-made incendiary
土制燃烧弹|Home-made incendiary
土制燃烧弹|Home-made incendiary
黑火药|Black powder
黑火药|Black powder
硝铵炸药|Explosive
硝铵炸药|Explosive
迫击炮弹|Mortar shells
炸弹|bomb
炸弹|bomb
雷管|Detonator
雷管|Detonator
燃烧瓶|Molotov cocktails
燃烧瓶|Molotov cocktails
燃烧瓶|Molotov cocktails
塑料炸弹|Plastic explosives
塑料炸弹|Plastic explosives
petn|PETN
petn|PETN
尼泊尔刀|Nepal knife
尼泊尔刀|Nepal knife
尼泊尔狗腿刀|Nepal dogleg knife
尼泊尔狗腿刀|Nepal dogleg knife
斩马刀|Zhanma Dao
斩马刀|Zhanma Dao
三棱刀|Tri knife
博伊刀|Boyd knife
博伊刀|Boyd knife
廓尔喀刀|Kukri
廓尔喀刀|Kukri
蜘蛛刀|Spider knife
蜘蛛刀|Spider knife
苗刀|Miao knife
蝴蝶甩刀|Butterfly flail
蝴蝶甩刀|Butterfly flail
卡巴刀|Ka-Bar
卡巴刀|Ka-Bar
勃郎宁刀|Browning knife
勃郎宁刀|Browning knife
匕首|dagger
三棱刮刀|Triangular scraper
三棱刮刀|Triangular scraper
跳刀|Jump knife
军品刺刀|Military bayonet
军品刺刀|Military bayonet
d80军刺|d80 Shanker
d80军刺|d80 Shanker
战术刀具|Tactical Tool
战术军刀|Tactical Saber
战术军刀|Tactical Saber
麻醉弩箭|Anesthesia bolt
麻醉弩箭|Anesthesia bolt
精品弓弩|Toys crossbow
精品弓弩|Toys crossbow
弩弓制作图纸|Crossbow production drawings
弩弓制作图纸|Crossbow production drawings
黑森林弓弩|Black Forest crossbow
黑森林弓弩|Black Forest crossbow
三健弓弩|Threebond crossbow
三健弓弩|Threebond crossbow
弓弩麻醉箭|Anesthesia crossbow arrow
弓弩麻醉箭|Anesthesia crossbow arrow
森林之鹰|Eagle Forest
小飞狼|Flying Wolf
森林之狼|Wolf Forest
气枪弩|Crossbow airguns
军用弩箭|Military bolt
军用弩箭|Military bolt
猎豹弓弩|Cheetah crossbow
猎豹弓弩|Cheetah crossbow
弩枪|Crossbow gun
弩枪|Crossbow gun
十字弩|Crossbow
钢弩|Arbalest
狩猎弩|Hunting crossbow
狩猎弩|Hunting crossbow
警用弩|Police crossbow
大黑鹰弓弩|Great Black Hawk crossbow
大黑鹰弓弩|Great Black Hawk crossbow
黑曼巴弩|Black Mamba crossbow
黑曼巴弩|Black Mamba crossbow
k粉|K powder
k粉|K powder
去甲麻黄碱|Norephedrine
去甲麻黄碱|Norephedrine
季戊四醇|Pentaerythritol
季戊四醇|Pentaerythritol
麻古制作技术|Ma old production technology
麻古制作技术|Ma old production technology
氯胺酮制作配方|Ketamine Recipes
氯胺酮制作配方|Ketamine Recipes
k粉制作方法|k powder production methods
k粉制作方法|k powder production methods
fm2|FM2
k粉制作技术|k powder production technology
k粉制作技术|k powder production technology
麻古制作方法|Ma old production methods
麻古制作方法|Ma old production methods
丁丙诺啡|Buprenorphine
丁丙诺啡|Buprenorphine
丁丙诺啡|Buprenorphine
氟硝安定|Flunitrazepam
氟硝安定|Flunitrazepam
氟硝安定|Flunitrazepam
安纳咖|Anna coffee
安纳咖|Anna coffee
安纳咖|Anna coffee
摇头丸|Ecstasy
摇头丸|Ecstasy
天然可卡因|Natural cocaine
天然可卡因|Natural cocaine
去氧麻黄素|Methamphetamine
去氧麻黄素|Methamphetamine
黄曲霉素|Aflatoxin
黄曲霉素|Aflatoxin
黄曲霉素|Aflatoxin
氯化银钾|Potassium chloride, silver
氯化银钾|Potassium chloride, silver
氯化银钾|Potassium chloride, silver
安乐死药物|Euthanasia Drug
安乐死药物|Euthanasia Drug
敌恶磷|Evil enemy phosphorus
敌恶磷|Evil enemy phosphorus
敌恶磷|Evil enemy phosphorus
敌杀磷|Kill enemy phosphorus
敌杀磷|Kill enemy phosphorus
敌杀磷|Kill enemy phosphorus
氯硫酸|Chlorine sulfuric acid
氯硫酸|Chlorine sulfuric acid
氯硫酸|Chlorine sulfuric acid
甲烷磺酰氯|Methanesulfonyl chloride
甲烷磺酰氯|Methanesulfonyl chloride
甲烷磺酰氯|Methanesulfonyl chloride
四氯硫代碳酰|Tetrachloro carbothiohydrazide
四氯硫代碳酰|Tetrachloro carbothiohydrazide
四氯硫代碳酰|Tetrachloro carbothiohydrazide
甲基磺酰氟|Sulfonyl fluoride
甲基磺酰氟|Sulfonyl fluoride
甲基磺酰氟|Sulfonyl fluoride
氯气|Chlorine
氯气|Chlorine
三氯硫氯甲烷|Methane, sulfur, chloride
三氯硫氯甲烷|Methane, sulfur, chloride
光气|Phosgene
光气|Phosgene
氯化硫酰甲烷|Thionyl chloride, methane
氯化硫酰甲烷|Thionyl chloride, methane
氯化硫酰甲烷|Thionyl chloride, methane
过氯甲硫醇|Perchlorate methyl mercaptan
过氯甲硫醇|Perchlorate methyl mercaptan
过氯甲硫醇|Perchlorate methyl mercaptan
氯化硫酸|Chloride, sulfuric acid
氯化硫酸|Chloride, sulfuric acid
氯化硫酸|Chloride, sulfuric acid
液氯|Chlorine
液氯|Chlorine
氟醋酸钠|Fluorine sodium acetate
氟醋酸钠|Fluorine sodium acetate
氟醋酸钠|Fluorine sodium acetate
流氓燕|Rogue Yan
流氓燕|Rogue Yan
凛冬烈火|Winter on fire
凛冬烈火|Winter on fire
掌心雷|Palm Thunder Pistol
掌心雷|Palm Thunder Pistol
tnt炸药|TNT explosives
土炸药|Soil explosives
土炸药|Soil explosives
遥控炸弹|Remote-controlled bomb
遥控炸弹|Remote-controlled bomb
遥控炸弹|Remote-controlled bomb
鱼雷|Torpedo
鱼雷|Torpedo
定时炸弹|Time Bomb
定时炸弹|Time Bomb
导火索|Fuse
导火索|Fuse
电子炸弹|Electronic bomb
电子炸弹|Electronic bomb
电子炸弹|Electronic bomb
工业雷管|Detonator
工业雷管|Detonator
军用雷管|Military detonator
军用雷管|Military detonator
高爆炸药|High explosive
高爆炸药|High explosive
液体炸药|Liquid explosives
爆破剂|Blasting agents
自制炸弹|Homemade bomb
自制炸弹|Homemade bomb
氢弹|hydrogen bomb
巡航导弹|cruise missile
手雷|Grenade
手雷|Grenade
土炸弹|Earth bomb
硅烷炸弹|Silane bomb
硅烷炸弹|Silane bomb
汽油弹|Petrol bombs
导弹|missile
催泪弹|Tear bomb
催泪弹|Tear bomb
黑索今|RDX
黑索今|RDX
黄色炸药|TNT
黄色炸药|TNT
液体炸弹|Liquid bomb
烟雾弹|smoke bomb
硝胺炸药|Nitroamine explosives
硝胺炸药|Nitroamine explosives
硝酸胺炸药|Ammonium nitrate explosives
硝酸胺炸药|Ammonium nitrate explosives
太恩|Too Well
太恩|Too Well
太安|PETN
太安|PETN
水胶炸药|Water gel explosive
水胶炸药|Water gel explosive
手榴弹|Grenade
手榴弹|Grenade
三硝基甲苯|TNT
三硝基甲苯|TNT
三硝基甲苯|TNT
三硝基苯酚|Trinitrophenol
三硝基苯酚|Trinitrophenol
三硝基苯酚|Trinitrophenol
乳化炸药|Emulsion explosives
乳化炸药|Emulsion explosives
乳化炸药|Emulsion explosives
莫洛托夫鸡尾酒|Molotov cocktail
莫洛托夫鸡尾酒|Molotov cocktail
莫洛托夫鸡尾酒|Molotov cocktail
雷汞|Mercury fulminate
雷汞|Mercury fulminate
雷汞|Mercury fulminate
内裤炸弹|Underwear bomb
内裤炸弹|Underwear bomb
内裤炸弹|Underwear bomb
黑索金|RDX
黑索金|RDX
黑索金|RDX
导爆索|Detonating cord
导爆索|Detonating cord
导爆索|Detonating cord
铵油炸药|ANFO
铵油炸药|ANFO
铵油炸药|ANFO
铵梯炸药|TNT Explosive
铵梯炸药|TNT Explosive
硝化甘油|Nitroglycerine
硝化甘油|Nitroglycerine
硝化甘油|Nitroglycerine
原子弹|Bomb
原子弹|Bomb
tnt|TNT
tnt|TNT
燃烧弹|Incendiary
燃烧弹|Incendiary
燃烧弹|Incendiary
c4|C4
c4|C4
炸药|Dynamite
炸药|Dynamite
psiphon|Psiphon
goagent|GoAgent
goagent|GoAgent
xskywalker|XSkyWalker
xskywalker|XSkyWalker
vpn|vpn
islam|islam
awazi|awazi
awazi|awazi
radiosi|radiosi
albumi|albumi
nadir|nadir
jundullah|jundullah
jundullah|jundullah
muhammad|muhammad
turkistan|turkistan
jihad|jihad
jordanian|jordanian
pugno|pugno
blmjkwekd48|BLmjkwekd48
tubalilghuraba2|TubaLilghuraba2
tvbreab|TvBreab
tvbreab|TvBreab
xybreab|XyBreab
xybreab|XyBreab
lsereab|LSEreab
lsereab|LSEreab
ptereab|PTEreab
ptereab|PTEreab
vax9cab|VAX9cab
vax9cab|VAX9cab
ym9mcab|YM9mcab
ym9mcab|YM9mcab
riircab|RIIrcab
riircab|RIIrcab
nqiwbab|Nqiwbab
nqiwbab|Nqiwbab
翻墙|Wall
翻墙|Wall
自由门|Freegate
自由门|Freegate
南海仲裁|South China Sea arbitration
南海仲裁|South China Sea arbitration
海牙|Hague
仪仗队女兵|Female guard of honor
仪仗队女兵|Female guard of honor
nihao99|Nihao99
山东孙文广|Shandong Sun Wenguang
山东孙文广|Shandong Sun Wenguang
访民自由|Petitioners freedom
访民自由|Petitioners freedom
wuaijiuba|Wuaijiuba
lfyle|Lfyle
ummetislam|Ummetislam
ummetislam|Ummetislam
kavkazcenter|Kavkazcenter
致迁徙者的忠告|Induced migrants Advice
mpvcr|pvcr
长尾高丽|Elliot Korea
长尾高丽|Elliot Korea
温家宝|Wen Jiabao
温家宝|Wen Jiabao
温家宝|Wen Jiabao
天安门|Tiananmen
轻型飞机|Light aircraft
飞艇|Airship
动力伞|Paramotor
航拍飞艇|Aerial airship
载人气球|Manned balloon
四旋翼无人机|Quad-rotor UAV
广告飞艇|Advertising airships
遥控飞艇|Remote Control Airship
滑翔机|Glider
遥控飞机|Remote control aircraft
四轴航模|Axis HM
直升机|Helicopter
极路由|Gee Router
威众路由器|Granville Public router
加密路由器|Encryption Router
跳跳加速器|Jumping Accelerator
悠悠代理|Lengthy Agent
艾薇百科|Avril Encyclopedia
vpn800|PN800
sqshxx|qshxx
电视棒成人版|TV Stick Adult Edition
成人影视棒|Adult Film stick
王岐山|Wang Qishan
香港民族论|On Hong Kongese Nationalism
藏区秘行|Tibetan secret line
西藏危机|Tibet crisis
胡锦涛|Hu Jintao
胡锦涛|Hu Jintao
胡锦涛|Hu Jintao
2015大猎杀|015 Big Hunt
2016中共崩溃|2016 Communist collapse
推销中共|Marketing the CPC
习式政治|Xi style politics 
邓小平|Deng Xiaoping
邓小平|Deng Xiaoping
达赖喇嘛|Dalai Lama
雪域的民族主义|Snowy nationalism
藏土出中国|Tibetan soil of China
赤风呼啸|Red Wind whistling
流亡中的民主|Exile Democracy
流亡中转型|Exile in transition
西藏生死书|The Tibetan Book of Living and Dying
大崩塌临界点|Tipping Point of the great collapse
天津核爆炸|Explosions in Tianjin were nuclear
天津和上海|Tianjin and Shanghai 
继续打虎|Continue Tiger
老江气杀习大大|Old Jiang Xi much gas to kill
元老政治|Veteran political
国共恩怨|KMT and scores
大老虎秘密名单|big tiger secret list
2015大审判年|big trial in 2015
超级大老虎|Super Tiger
太上皇与庆亲王|Overlord and Prince Qing
贪官后宫奇闻|Corrupt harem anecdote
十九大争夺战|Power Struggle Battle on the 19th National Congress of the Communist Party of China
公共情妇郭美美|Public Mistress Guo Meimei
周永康之子周滨|Zhou Yongkang son Zhou Bin
李克强因病辞职|Li Keqiang resign due to illness
2015大劫难|015 great catastrophe
xssyx|Xssyx
坚守科巴尼|Hold Fast Kobane
叙利亚|Syria
yunpan|Yunpan
weiyun|Weiyun
工字牌|Workers plates
仿真|Emulation
朝鲜冰|North Ice
朝鲜冰|North Ice
溜冰壶|Skating pot
溜冰壶|Skating pot
安乐死|Euthanasia
三陪|scort
打鸟枪|Shotgun hit
麻古|Magu
特级运动|Premium Sport
汽枪|air rifle 
气狗|Air Dogs
92式|Type 92
77式|77 type
654k|
三角牌|Triangle
狗粮|Food
铅弹|Pellet
54式|54 formula
军品网|Military Network
气枪|Airsoft
气枪|Airsoft
军火|Arms
甲麻黄碱|Norephedrine
甲基苯丙胺|Methamphetamine
甲基苯丙胺|Methamphetamine
氯胺酮|Ketamine
氯胺酮|Ketamine
氯胺酮|Ketamine
可卡因|Cocaine
麻果壶|Ma fruit pot
麻果壶|Ma fruit pot
麻古壶|Ma old pot
麻古壶|Ma old pot
钻石冰|Diamond Ice
钻石冰|Diamond Ice
黄冰|Huang Bing
秃鹰网|Network Vulture
淘宝秃鹰|Taobao Vulture
中华打猎|Chinese Hunting
中国猎人|China Hunter
中华猎坛|Hunting Chinese altar
枪友|Friends of gun
秃子|Baldy
亚洲狩猎|Asia Hunting
手狗|Hand Dog
炮弹|Shells
狗腿刀|Dogleg knife
狗腿刀|Dogleg knife
三棱|Tri
军刺|Shanker
刺刀|Bayonet
军刀|Saber
弩箭|Bolt
弩|Crossbow
麻醉箭|Anesthesia Arrow
硝化棉|Nitrocellulose
百老汇|roadway
制备|Preparation
tatp|TATP
撒旦之母|Mother of Satan
塑胶|Plastic
c4橡胶|C4 rubber
水胶|Water glue
硝铵|Ammonium Nitrate
铵梯|- TNT -
diy|DIY
制造|Manufacturing
制作|Create
订购|Order
交换|Exchange
专卖|Monopoly
转让|Transfer
提供|Provide
供应|Supply
加工|Processing
自制|Homemade
见面交易|Trading meet
货到付款|Delivery
批发|Wholesale
tatp制作|Tatp production
三过氧化三丙酮|Three peroxide triacetone
合成|Synthesis
烈焰的召唤|Call of Flame
化学物品合成|Chemical synthesis
土雷|Earth mine
火焰喷射器|Flamethrower
硝基脲|Nitrosourea
硝酸碳酰肼锰|CARBOHYDRAZIDE manganese nitrate
hmtd|HMTD
翻墙工具|Circumvention tools
赛风|Psiphon
vpn代理|Vpn proxy
islam_awazi|Islam_awazi
islam_awazi|Islam_awazi
氰化|Cyanide
氯化|Chloride
