六四|Sixty-four
学潮|Campus upheaval
操你妈|Fuck
法轮|Falun
flg|
falungong|
falundafa|
fuck|
真善忍|Truthfulness Compassion Tolerance
大纪元|Epoch Times
吾尔开希|Wuerkaixi
方励之|Fang Lizhi
未来中国论坛|Future China Forum
高勤荣|Gap Qinrong
胡紧掏|Hu tight dig
黄菊|Huang Ju
江绵恒|Jiang Mianheng
张德江|Zhang Dejiang
赵紫阳|Zhao Ziyang
瘟家宝|Wen Jiabao
共匪|Communist gangsters
美国之音|Voice of America
零八宪章|Charter 08
刘晓波|Liu Xiaobo
丁子霖|Ding Zilin
口交|Oral sex
性交|Sexual intercourse
援交|Enjo
轮奸|Gang rape
共惨党|Miserable party
一党专政|One-party dictatorship
江贼民|Jiang Zei Min
肏屄|Fuck cunt
八九|Eighty-nine
河殇|River Elegy
八九民运|1989 Democracy Movement
肉洞|Roudong
操逼|Operating force
骚逼|Sao force
淫水|Sexual secretion
逼样|Force sample
妈逼|Mom forced
屁眼|Asshole
二b|Two B
阴部|Private parts
阴毛|Pubes
出售手枪|Pistol sale
结束一党专政|End one-party dictatorship
真理部|Ministry of Truth
茉莉|Jasmine
习胖子|Fat man Xi
五月三十五|May 35th
温影帝|Best Actor Wen
二十二年前|22 years ago
瓶反鹿死|Redress June Fourth
办证|Processing certification
薄熙来|Bo Xilai
视频裸聊|Nude video chat
成人视频下载|Adult Video Downloads
高仿毕业证|High quality imitation diploma
办证服务公司|Company that processes certification
办理大专文凭|Processing junior college diplomas
出售x卧底|Selling Xwodi
美女激情视频|Beauty passion video
电购数据|Information on television shopping
08宪章|Charter 08
38军|38th Army
92式|Type 92
chailing|
fa-luen|
falun|
freeliuxiaobo|
hexun|
k粉|K powder
lihongzhi|
lipeng|
luen功|luen power
q q|
six四|Jun 4
six月four日|Jun 4
zemin|
白粉|White powder
白皮书|White paper
百家乐|Baccarat
包养|Nurturing
保钓|Diaoyu Islands
保护伞|Umbrella
鲍彤|Bao Tong
暴政|Tyranny
冰毒|Meth
博讯|Boxun
藏独|Tibetan separatist
曾庆红|Zeng
陈子明|Chen Ziming
陳水扁|Chen Shui-bian
赤匪|Red bandits
赤化|Communization
畜生|Beast
达赖|Dalai
打倒|Down
大法|Dafa
大中华论坛|Greater China Forum
邓小平|Deng Xiaoping
抵制|Boycott
弟子|Disciple
钓鱼岛|Diaoyu Islands
动乱|Turmoil
动态网|Dynamic Network
毒品|Drugs
独裁|Dictatorship
法輪|Falun
反人类|Crimes against humanity
反日|Anti-Japan
分裂|Split
封杀|Ban
傅怡彬|Fu Yibin
告全体网民书|Report all Internet users book
工自联|Independent Workers' Alliance
共党|Communists
管理员|Administrator
汉人|Han
賀國強|He Guoqiang
胡海青|HU Hai-qing
胡海清|Hu Haiqing
胡星斗|Mr Hu
胡耀邦|Hu Yaobang
华岳|Huayue
回民|Hui
慧网|Hui network
集会|Assembly
监听器|Monitor
江泽民|Jiang
疆独|East Turkistan separatists
讲法|Argument
戒严|Martial law
警察|Police
抗议|Protest
李長春|Li Changchun
李洪志|Li Hongzhi
李克强|Li Keqiang
李岚清|Li
李瑞环|Li
李小鹏|Li Xiaopeng
李长春|Li Changchun
梁光烈|Liang Guanglie
两会|Two sessions
论坛|Forum
卖国|Traitorous
民进党|DPP
民运|MDC
民阵|DFLP
民主|Democracy
穆斯林|Muslim
迫害|Persecution
气枪|Air gun
热比娅|Rebiya Kadeer
人权|Human rights
任畹町|Ren Wanding
社区|Community
圣战|Crusade
示威|Demonstrate
台湾|Taiwan
太子党|Princelings
天怒|Wrath
田纪云|Tian
铁流|Tieliu
统战|United Front
推翻|Overthrow
退党|Resign
王希哲|Xizhe
网特|Network Special
魏京生|Wei Jingsheng
温云松|Wen Yunsong
文革|Revolution
乌尔开西|Open ur West
无帮国|No help country
吴邦国|Wu Bangguo
吳邦國|Wu Bangguo
伍凡|Wu Fan
勿忘六四|Do not forget sixty-four
西藏|Tibet
辛灏年|Mr. Xin
新党|New Party
新疆|Xinjiang
新唐人|NTDTV
新闻封锁|News blackout
新闻管制|Censorship
修炼|Practice
许志勇|Xu Zhiyong
学联|ACSF
学运|Student movement
血腥镇压|Bloody crackdown
杨东平|Yang Dongping
游行|Parade
炸弹|Bomb
炸药|Dynamite
张祖桦|Zhang Zuhua
政府|Government
支持|Stand by
中共|Chinese Communist Party
中南海|Zhongnanhai
朱容基|Zhu Rongji
朱鎔基|Zhu
主席|Chairman
自焚|Self-burning
胡锦涛|Hu
温家宝|Wen
贾庆林|Jia Qinglin
习近平|Xi Jinping
周永康|Zhou Yongkang
08xianzhang|
08县长|08 county
鲍筒|Bao barrel
北京当局|Beijing authorities
北京新报|Beijing Daily News
北京政权|Beijing regime
贬卖枪支|Derogatory sell firearms
柴玲|Chai Ling
陈小雅|Xiaoya Chen
成人电影网|Adult Movie Network
吃屎|Shit
持不同政见|Dissident
出售枪支|Sale of firearms
春夏之交|Spring and summer
打砸抢|Vandalism
大参考|Large reference
大陆民运|Continental pro
地下赌庄|Underground gambling Zhuang
杜兆勇|Du Zhaoyong
多维|Multidimensional
法轮大法|Falun Dafa
法轮功|Falun Gong
法轮正法|Falun Dhamma
反共|Anticommunist
范珍致|Fan Zhen cause
方觉|Fang Jue
肥b|Fat B
夫妻共插|Husband and wife co-plug
高景云|High King Wan
高文谦|High Wenqian
高自联|High self-linking
共铲党|Total shovel party
关舟|Off boat
国企大厦18层|State-owned 18-storey building
海外民运|Overseas democracy movement
何德普|He Depu
何清涟|He Qinglian
红色恐怖|Red Terror
洪吟|Hong Yin
洪志|Hongzhi
华惠棋|Hua Hui chess
回民暴动|Moslem riots
激情成人论坛|Passion Adult Forum
建联通|ImGO
江锦恒|Jiang Jinheng
江责民|Jiang Min responsibility
姜洪禄|Jiang Honglu
刻章办证发票|Rush invoice engraving
空中民主墙|Air Democracy Wall
老虎机破解中心|Slot machine crack center
李宏志|LI Hong-zhi
李宏治|Li governance
李旺阳|Li Wangyang
李月鸟|Li Yue birds
李志绥|Li Zhisui
李智英|Jee Young Lee
里藏春|In possession of the spring
林幼芳|Lin Youfang
刘凤钢|Liu steel
刘军宁|Liu Junning
刘文胜|Liu Wensheng
吕加平|Lu Jiaping
裸干|Bare Dry
民主潮|Democratic tide
民主墙|Democracy Wall
明hui|Ming hui
明慧|Minghui
明心|Ming heart
南华早报|South China Morning Post
破解水果机|Cracked fruit machine
情色俱乐部|Erotic club
色情俱乐部|Erotic club
石戈|Shi Ge
视频处女|Video Virgin
视频脱衣|Video Strip
苏晓康|Su Xiaokang
孙大午|Sun Dawu
天灭中共|Communist days off
退出共|Exit Total
退出中共的党|Quit Communist Party
退谠|Retreat Dang
脱光性交图|Figure naked sex
王丹|Wang Dan
王美茹|Wang Meiru
温加饱|Wen added saturated
温元凯|Wenyuan Kai
吾尔凯希|I 尔凯希
西藏独立|Tibet independence
谢小庆|Xie Xiaoqing
新疆独立|Xinjiang independence
徐永海|Xu Yonghai
严家其|Yan Jiaqi
杨春波|Yang Chunbo
杨子立|Yang Zili
余杰|Yu Jie
舆论钳制|Opinion clamp
张博函|Zhang Bo letter
张博涵|Zhang Bohan
张搏函|Zhang letter stroke
张搏涵|Zhang Han stroke
张桂芳|Land Management Act
张京生|Zhang Jingsheng
张晓平|ZhangXiaoping
张星水|Zhang Xing water
章虹|Zhang Hong
政治反对派|Political opposition
政治犯|Political
中国民主党|China Democratic Party
中国之春|China Spring
中宣部|Propaganda
朱胜文|Zhu Shengwen
朱穗生|Zhusui Sheng
朱文虎|Zhu Wenhu
转法轮|Zhuan Falun
自由花|Freedom Flower
测试a|Test A
sinauc|
sina uc|
sina uc|
新浪uc|Sina UC
黄片|Porn
阴茎|Penis
卖身|Bondage
操你|Fuck you
操他|He parade
a片|A piece
性伴侣|Sex partner
鸡巴|Cock
茎候佳阴|Jinghoujiayin
裸聊|Nude chat
luo聊|LUO chat
luo体视频|LUO body video
裸体视频|Nude video
性伙伴|Sexual partners
婊子|Whore
妓|Prostitute
新浪|Sina
系统消息|System Messages
系统通知|System Notification
uc巡管|UC patrol tube
系统管理员|System administrator
uc高管|UC executives
uc员工|UC staff
温馨提示|Tips
uc通知|UC notice
系统抽奖|Lottery system
在线管理|Online Management
10000|
系统公告|System Announcement
系统提示|Prompted
消息系统|Messaging System
消息提示|News Tip
三去|Three to go
活动提示|Activity Tips
提示|Prompt
公告|Announcement
uc-公告|UC- Announcement
台湾独立|Taiwan independence
共产党|Communist party
抵制奥运|Olympic boycott
反对奥运|Oppose the Olympics
活动信息|Event Information
放片|Release tablets
uc活动|UC Activities
新浪提示|Sina Tips
活动官方|Activities Official
ruihuan|
sars|
taidu|
webmaster|
k粉|k powder
系统信息|System Information
暴乱|Riot
操她|Fuck Her
插进|Inserted
陈良宇|Chen Liangyu
陈良玉|Chen Liangyu
陈水扁|Chen Shui-bian
抽插|Choucha
出台|Introduction
处女膜|Hymen
大陆当局|Mainland authorities
党国|State party
电聊|Electric chat
东突|East Turkistan
二奶|Mistress
反攻大陆|Retake the mainland
富妹|Fu-mei
富女|Rich women
肛交|Anal sex
肛门|Anus
高潮|Climax
共军|Communist troops
龟头|Glans
韩桂芝|Han Guizhi
韩贵芝|Han Guizhi
红顶商人|Hongdingshangren
红岗|Honggang
侯杰|Hou Jie
华莱士|Wallace
换妻|Wife Swap
黄教授|Professor Wong
鸡吧|Helping of chicken
姬胜德|Ji Shengde
几吧|Several bars
妓女|Prostitute
奸污|Rape
贱b|Cheap B
江公子|Jiang Gongzi
叫床|Jiaochuang
军队走私|Army smuggling
军妓|Prostitutes
来京上访|Beijing to petition
浪女|Sluts
老毛|Mao
李大师|Master Li
李登辉|Lee Teng-hui
李鹏|Li Peng
刘刚|Gang
刘杰告状|Liu Jie complain
刘金宝|Liu Jinbao
罗干|Luo Gan
马强|Ma Qiang
茅道临|Mao Daolin
美妇|Meifu
纳粹|Nazi
陪酒|Hostessing
强暴|Violent
禽流感|Avian Influenza
情色|Erotic
群奸|Gang rape
人民报|De Volkskrant
人之初|People at the beginning
肉棍|Rougun
肉穴|Rouxue
骚穴|Saoxue
上海帮|Shanghai Gang
呻吟|Moan
深喉|Deep Throat
生活情趣|Zest for life
十六大|Congress
吮吸|Suck
私处|Privates
四通|Stone
宋祖英|Zuying
苏锈文|Su Wen rust
苏秀文|Su Xiuwen
台独|Independence
陶驷驹|Tao Siju
体位|Position
天安门事件|Tiananmen Incident
天上人间|Heaven on earth
脱光|Naked
脱衣|Divestiture
晚年周|Week old age
万润南|Mason South
文化大革命|Cultural Revolution
文学城|Literary City
我是回民|I was Hui
吴官正|Wu
吴仪|Wu
下体|Nakedness
香港明报|Ming Pao
项怀城|Xiang City
消魂|Ecstasy
小参考|Small reference
小穴|Koana
小姨子|Sister
肖爱玲|Xiao Ailing
性爱|Eros
性福|Flirt
性技巧|Sexual skills
性生活|Sex life
徐匡迪|Xu
阳具|Penis
摇头丸|Ecstasy
一边一国|Each side
一九八九|One thousand nine hundred eighty-nine
一中一台|One Taiwan
伊斯兰|Islam
以德治国|By Virtue
阴唇|Labia
阴道|Vagina
淫荡|Lewd
隐私|Privacy
赵启正|Zhao
郑恩宠|Zheng Enchong
支那|Shina
中华民国|Republic of China
中银香港|BOCHK
周国强|Zhou Guoqiang
周正毅|Zhou Zhengyi
朱毛|Zhu Mao
猪的梦|Pig Dream
宗教压迫|Religious oppression
走光|Emptied
做爱|Sex
新浪管理员|Sina administrator
老虎机|Slot machine
远红外透视仪|Far-infrared instrument perspective
扑克仪器|Poker equipment
博客管理员|Blog administrator
办文凭|Office diploma
播客管理员|Podcasts Administrator
空间管理员|Space administrator
论坛管理员|Forum Administrator
删除负面信息|Remove the negative information
系统讯息|System Message
管理|Management
苏家屯|Sujiatun
日本使馆|Japanese Embassy
日本领事馆|Japanese Consulate
抵制日货|Boycott
日本大使馆|Japanese Embassy
江氏|Jiang
江氏控制权力|Jiang's grip on power
江氏控制|Jiang control
江氏控|Jiang control
8964|
退出中|Exiting
透视眼镜|Perspective glasses
透视手机|Perspective phone
淫妇|Adulteress
性爱聚会|Sex party
操你吗|Fuck you do
插b|Insert B
自慰|Masturbation
露奶|Dew milk
兽交|Bestiality
uc官方|uc official
信息中心|Information Center
uc官方|UC official
毛泽东|Mao
3p|
核心|Core
info|
administrator|
admin|
温如春|Wen Ruchun
系統信息|System Information
六四在行动|Sixty-four in action
李克強|Li Keqiang
習近平|Xi Jinping
賈慶林|Jia Qinglin
溫家寶|Wen
胡錦濤|Hu
臊逼|Bashfulness force
自拍|Self
朱镕基|Zhu
镇压|Repression
泽民|Zemin
幼女|Young girl
一夜情|One Night Stand
一夜|Night
养眼|Seductive
消息|News
系统|System
文凭|Diploma
王建军|Wang Jianjun
推油|Push oil
通知|Notification
贪官|Corrupt
丝袜|Stockings
首富|Richest man
少女|Maiden
少妇|Young woman
三个代表|Three
肉棒|Roubang
人体|Human body
妻子|Wife
女优|Actress
美女激情|Beauty passion
美国|United States
马克思|Marx
马宝|Marble
裸露|Bare
吕秀莲|Annette
流氓|Rogue
林彪|Lin Biao
两个中国|Two-China
李禄|Li Lu
经文|Scripture
精英|Elite
激情|Enthusiasm
公司|The company
富婆|Fupo
风骚|Coquettish
非典|SARS
放纵|Indulgence
代理|Proxy
大校|Colonel
大亨|Tycoon
处女|Virgin
冰火|Addict
贝领|Tony collar
澤民|Zemin
屄|Vulva
傒统信息|Servant system information
ze_min|
rui_huan|
rongji|
rong_ji|
li_peng|
dafa|
16大|16 large
喜讯|Good news
成人黄站|Adult yellow station
激情片下载|Passionate movie download
我爱我色网址|I love I'm sexual url
浴室干骚女系列|Bathroom fucking and harassing women series
操烂骚货|Parade rotten tart
成人聊天室|Adult chat rooms
美女qq裸舞|QQ dance naked beauty
我做骚妻|I'm a slutty wife
性爱淫图|Figure kinky sex
一本道电影|A road movie
美女b毛图|Beautiful woman pubic hair picture
成人网站导航|Adult site navigation
龟头对准阴道|Glans alignment vagina
插姐姐嫩穴|Fuck sister's soft vagina
淫穴里骚水|Cum in kinky hole
色情倚天屠龙记|Porn Sabre
老师的小穴|Teacher's pussy
淫奸电影|Kinky rape movies
我要性交网|I want sex network
淫网|Kinky Network
淫妹妹|Kinky sister
交换姐妹花|Exchange sisters
淫欲城堡|Lust Castle
艳遇编年史|Aventure Chronicles
少妇白洁|Young wife white clean
我的美女后宫|My beautiful harem
露b|Exposed vagina
性开放俱乐部|Is open to club
现代艳帝传奇|Yan Emperor modern legend
淫术炼金士|Kinky technique alchemist
倚天屠龙别记|Kung Fu do not remember
星光伴我淫|Walk with me kinky
美少妇的哀羞|Beautiful young wife's mourning and shame
逃亡艳旅|Escape brilliant trip
十景缎|Ten satin
不良少女日记|Bad girl diary
我的性启蒙老师|My sex teacher
学生妹|School girl
e夜情|one night stand
激情自拍|Passion Self
激情视频|Passion video
阴蒂|Clitoris
口暴|Port storm
激情小电影|Small Passion movie
阴户|Vagina
乱伦|Incest
三级片|Porn
催情粉|Aphrodisiac powder
淫叫|Yinjiao
开苞|Kaibao
露毛|Thoen, goog
乱交|Promiscuity
奶子|Breast
喷精|Fine spray
阴门|Vulva
阴囊|Scrotum
草榴|Grass pomegranate
群交|Group Sex
嫩穴|Nenxue
成人影院|Adult theater
兼职妹妹|Part sister
淫穴|Yin Xue
兼职小姐|Miss Part
xl51uc|
四二六社论|April 26 editorial
吾尔开西|Wu'erkaixi
吾尔凯西|Wu'erkaixi
吴仁华|Wu Renhua
北京之夏|Beijing's summer
刘晓竹|Liu bamboo
刘宾雁|Liu Binyan
六四事件|June incident
六四风波|Sixty-four storm
六four|Six four
六*四|Six * Four
八平方事件|Eight square Event
八jiu|Eight jiu
法学教授袁红冰|Law professor Yuan Hongbing
民主歌声献中华|Concert for Democracy in China
梁擎墩|Liang Qingdun
李淑娴|Li Shuxian
广场四君子|Four Gentlemen of Tiananmen Square
封从德|Feng Congde
坦克压死大学生|Students tanks crushed
坦克压学生|Pressure tanks students
国殇之柱|Pillar of Shame
乌尔凯西|Ur Casey
八的二次方|Quadratic eight
颠覆国家政权|Subversion of state power
李鹏日记|Li diary
八9六4|Eight nine six four
六四真相|Tiananmen truth
广场上的热血|Blood on the square
liu晓波|liu Xiaobo
8玖|8 Nine
燃烧瓶|Molotov cocktails
biz|
org|
乳头|Nipple
綉|Show
肏|Fuck
穴|Cave
六间房|Six rooms
gua|
kk18|
99cu|
happy88|
lele08|
惈|Guo
eu|
ww w|
je|
tv|
ｗｗｗ|
net|
cn|
com|
秀|Beautiful
ddn|
倮|Luo
ｃｏｍ|
ｃｎ|
ｎｅｔ|
ｈｔｔｐ|
ｃｎ|
ｎｅｔ|
ｃｏｍ|
tc|
ｉｎｆｏ|
ｗｗｗ|
ｈｔｔｐ|
tf|
www|
ｉｎｆｏ|
唐|Tang Dynasty
im|
成人|Adult
脱|Take off
vg|
at|
骡|Mule
ｃn|
bit|
gd|
ｃ ｎ|
ｃ ｏｍ|
ｃｏ ｍ|
脫|Take off
运營|Operations
co m|
c n|
ne t|
n et|
ｎ ｅｔ|
ｎｅ ｔ|
ｗｗ ｗ|
ｗ ｗｗ|
w ww|
百老汇|Broadway
裸|Naked
瓜瓜|Guagua
w w w|
酷6|Cool 6
呱|Quack
躶|Luo
露点|Dew point
免费|Free
收费|Toll
阳萎|Impotence
網址|Site
c om|
hk|
捰|Luo
网址|Site
地址|Address
馃|Guo
骒|Ke
to|
奂|Huan
gs|
、|
咪咪|Mimi
猓|Guo
ie|
腂|Guo
粿|Cakes
st|
am|
us|
泄|slip
射|ejaculate
kz|
唐人街|Chinatown
干我|Fuck me
騍|Ke
锞|Ingot
褁|Guo
堁|Ke
乳|Milk
脫光|Naked
x10|
lnk|
wk|
jm|
趾|Toe
网站|Website
mu|
lc|
輠|Guo
蜾|Eumenes pomiformis
髁|Condyle
猡|Luo
綶|Guo
淉|Guo
婐|Wo
餜|Pastry
cr|
奶|Milk
酷六|Cool six
脫光光|Strip light
tk|
nu|
cm|
錁|Ingot
境外势力|Foreign forces
新疆恐怖分子|Xinjiang terrorists
騾|Mule
婊|Prostitute
妈|Mom
操|Exercise
范长秘|Fan Changmi
郭正钢|Guo Zhenggang
党魁|faction leader
姜野飞|Jiang Yefei
薄周政变|Bo-Zhou coup
明镜网|Der Spiegel news
明镜博客|Der Spiegel blog
vnsc1|
习匪|Xi bandit
异教徒|Heathen
圣战战士|Jihad fighters
网　址|Website
摞聊|Pile chat
.cn|
性交易|Transactions
上门服务|On-site service
成人视频|Adult Video
打炮|Shelling
鸡婆|Gods
美女裸体|Beautiful nude
美女援助|Beauty aid
美女电话|Beauty phone
公关包养|PR nurturing
全套包夜|A full night package
sm服务|SM Service
三陪|Escort
上门援交|Home enjo
上门提供|Home to provide
良家性息|Decent of interest
一对一|One to One
小姐|Miss
3p乱交|3p promiscuity
情色网|Erotic Network
色情电影|Porn
情色电影|Erotic Movie
av女优|av Actress
av|
种子下载|Seed download
无码|Uncensored
不良少女|Bad girl
草榴影院|Grass pomegranate theater
黄色影院|Yellow theater
东京热|Tokyo Hot
迷奸|GHB
黄色动漫|Yellow cartoon
免费成人|Free adult
欧美成人|European and American adult
欧美情色|European and American Erotica
强奸|Rape
人兽|Man and beast
日本成人|Japanese adults
日本黄片|Japanese porn
日本幼女|Japanese girl
日韩av|Japan and South Korea av
色咪咪|Se Mimi
色情|Porn
哇嘎|Wow Ga
一本道|A Road
tnt|
c4炸药|C4 explosives
炸药配方|Dynamite recipe
吸毒|Drug
溜冰|Ice skating
赌坊|Dufang
赌房|Gambling house
赌博|Gambling
坐庄|Zuozhuang
c	o	m|
习精瓶|Xi fine bottle
吸精瓶|Absorption fine bottle
慶豐帝|Qingfeng Timor
習胖|Xi Fat
習胖胖|Xi fat
習胖子|Xi Fat
習二胖|Xi two fat
習三胖|Xisan fat
習大腦袋|Xi big head
習大頭|Xi bulk
習大臉|Xi big face
習狗|Xi dog
習歪歪|Xi YY
習賊|Xi thief
習做夢|Xi dream
刁書記|Diao Shuji
刁總|Diao total
洗盡平|Xi Jin Ping
習匪|Xi bandit
習特勒|Xi Teller
王雞山|King Chicken Hill
習二逼|Learning two force
習二平|Xi two flat
習禁評|Ban Xi comment
習夢思|Xi Mengsi
習精瓶|Xi fine bottle
習二夶|Xi two 夶
庆丰帝|Qingfeng Timor
包子帝|Emperor buns
习胖|Xi Fat
习胖胖|Xi fat
习二胖|Xi two fat
习三胖|Xisan fat
习大脑袋|Xi big head
习大头|Xi bulk
习大脸|Xi big face
习狗|Xi dog
习歪歪|Xi YY
习贼|Xi thief
习做梦|Xi dream
刁主席|Diao President
刁书记|Diao Shuji
刁大大|Diao greatly
刁总|Diao total
刁近平|Diao nearly flat
洗尽平|Xi Jin Ping
刁-大犬|Diao - Big Dog
习特勒|Xi Teller
王鸡山|King Chicken Hill
习二逼|Learning two force
习二平|Xi two flat
习禁评|Ban Xi comment
习梦思|Xi Mengsi
彭大麻|Peng marijuana
习包子|Xi buns
美国神韵|American charm
666|
不6|No 6
奸|Evil
权力分布图|Power distribution
回良玉|Hui Liangyu
吉林帮|Jilin help
大权独揽|Helm
嘭骂骂|Mama bang
周永康自辩书|Zhou Yongkang self-defense book
政变完整版|Coup full version
刀把子习|Dao child learning
飞猪骑士|Flying Pig Knight
中纪委|CCDI
终结一党专制|End one-party dictatorship
李源潮|Mr Li
网 址|Website
嚸|Dim
暴徒|Thug
色聊|Color chat
典改点|Code change point
市政府|City Hall
乌市 游行|Urumqi parade
全能神|Almighty God
大秀|Big show
刘云山|Liu Yunshan
刘奇葆|LiuJiBao
傅振华|Fu Zhenhua
栗战书|Li gauntlet
选择性反腐|Selective anti-corruption
tl/9l58|
控股安泰集团|ING Group Holdings
铲除异己|Elimination of dissidents
政治清洗|Political Cleaning
主席终身制|Chairman of tenure
彭丽媛|Peng Liyuan
艳照|Pornographic
仪仗队女兵|Female guard of honor
山东孙文广|Shandong Sun Wenguang
艾力.买土送|Soil send Eric Buy
访民自由|Petitioners freedom
东突厥斯坦|East Turkestan
大毛拉教义|Maulana doctrine
伊斯兰之声|Sound of Islam
公道来了|Justice to the
奸诈走了|Treacherous go
突厥斯坦|Turkestan
大毛拉|Maulana
魔鬼的朋友战斗|Devil's friends fighting
我们的道路|Our road
有教益故事|Instructive story
卡菲尔|Kaffirs
宗教解释|Religious interpretation
527yl|
31tc|
qiyue98|
9158spx|
5186t|
wuaijiuba|
lfyle|
ummetislam|
kavkazcenter|
周恩来|Zhou Enlai
三去车仑|Sanqujulun
你妈逼|Your mother forced
作爱|Make love
乳房|Breast
睾丸|Testis
淫欲|Lust
射精|Ejaculation
操我|Fuck me
手淫|Masturbation
大腿的缝隙|Slit thigh
大腿缝隙|Thigh gap
大腿的缝里|Crevices thigh
大腿缝里|Thigh crevices
茎侯佳阴|Jinghoujiayin
尻|Tajiri
抗日|Anti-Japanese
天鹅绒革命|Velvet Revolution
颜色革命|Color revolution
插b|Insert b
摸b|Touch B
摸b|Touch b
肛胶|Anal glue
7gua|
k521|
y8848|
t218.|
y236.|
35e.|
4ne|
7qi|
qs58.|
sy00.|
vv1688.|
.21na.|
.1999n.|
.6u6.|
.7ne|
.jsqq.|
.pvs.|
.7u7.|
.dns.|
.1www.|
.nk4.|
.bydou.|
.mm9mm.|
.corn.|
.corn.|
.3xb.|
.sho.|
.xo0.|
.lqiang.|
.elhao.|
.elhao.|
.sh0.|
.cnob.|
.h1d114.|
.dkz888.|
.zmov.|
.t1u.|
.qq23.|
.530mi.|
.bak.|
.i1l.|
.mo7758.|
.7t1.|
.377k.|
.377k.|
.vc258.|
.881188.|
.0234.|
.bot4u.|
.k251.|
.8ku.|
v6969.|
.111n.|
7gua|
%2e|
w396.|
w396.|
.xiongmin.|
bg558.|
.mp125.|
ok256|
.mm267|
.5we|
script|
傻逼|Shabi
.3377.|
.7799.|
傻ｂ|Silly B
傻b|Silly B
草你妈|Grass your mother
王八蛋|Son of a bitch
.mp125.|
51vip.|
装b|Loaded B
装b|Loaded b
模b|B-mode
叉b|Fork B
mp199|
1000ai.|
k251.|
9s5.|
.guxx.|
icesea.|
.6e66.|
.hooi.|
.woniubi.|
.mm267.|
.baxun.|
.88cn.|
.uqc.|
.6699.|
.788p.|
.0055.|
.0807.|
.1a.|
.1a.|
.mp199.|
.bg558.|
.yyew.|
.764s.|
.01z.|
.764s.|
.01z.|
.518.|
.i567.|
.westmr.|
821|
.456k.|
.9496.|
.n3g.|
.1347.|
.360x.|
.29258.|
艳舞|Dancing
贱货|Bitch
545291777|
we666.|
草你娘|Grass your mother
烂比|Rotten than
全活|Full live
.669e.|
.669e.|
.0598sm.|
.5we.|
嫩b|Tender B
66693|
.xdan.|
.1035.|
.mm.|
.6w6w.|
.msm678.|
.uc456.|
.0576.|
.51vc.|
364381|
.tk696.|
老母|Mother
骚货|Tart
.cn.|
.ttko.|
63om|
63n|
444601|
q  q|
操b|B operation
cao|
503384828|
小b|Small B
你娘|Your mother
ｑ   ｑ|
大逼|Large force
um_ddddd|
乱轮|Chaos wheel
鸡情|Chicken Love
51|
边脱边聊|Edge off chatting
边脱边玩|Edge off while playing
倮聊|Luo chat
坐爱|Love to sit
正法|Dhamma
法輪功|Falun Gong
法輪大法|Falun Dafa
法輪功大法|Falun Dafa
verif_法轮功|VERIF_ Falun Gong
verif_9158|
verif_激情|VERIF_ passion
verif_法轮大法|VERIF_ Falun Dafa
mm走光|MM emptied
狗屎|Dog feces
贱逼|Cheap force
草你|Grass you
煞笔|Shabi
马眼|Horse eye
sm|
sm|
sex|
sex|
sex|
性伴|Partner
同性|Homosexual
3p|
淫|Kinky
骚|SAO
性游戏|Sex game
祼体|Naked body
搞b|Out B
摸奶|Touch milk
看鸡|Look chicken
鸡8|8 chicken
情夫|Lover
性感内裤|Sexy underwear
同性恋|Homosexual
语音性爱|Voice Sex
视频调教|Video tuning
乱抡|Chaotic whirl
找美女|Find beauty
色女|Color female
色男|Color man
爽死你|Shuangsi you
b肥|B fertilizer
操比|Operating ratio
同志|Comrade
妻肉|Wife meat
煽情|Sensational
毛片|MAO
偷情|Betrayal
变态|Metamorphosis
男同|Gay
女同|Lesbian
淫民|Kinky people
抵制家乐福|Carrefour boycott
五一不去家乐福|Fifty-one go Carrefour
不去家乐福|Go to Carrefour
五一 家乐福|Fifty-one Carrefour
51 家乐福|51 Carrefour
不去 家乐福|Go to Carrefour
拒绝 家乐福|Carrefour refused
罢买 家乐福|Carrefour boycott
拒买 家乐福|Carrefour boycott
家乐福 攻略|Carrefour Raiders
五一 家乐|Fifty-one music
王毅|Wang Yi
.cc|
.tw|
.to|
.gd|
.ws|
收费聊天|Pay chat
私密处|Private office
软件群发|Software mass
幸运码|Fortunately code
视聊|Depending on chat
李健|Li Jian
管理員|Administrator
系統管理員|System administrator
退出中國|Exit China
退黨|Resign
湘聊|Gordon chat
三湘|Sunshine
氯胺酮|Ketamine
咖啡因|Caffeine
安纳咖|Anna coffee
氟硝安定|Flunitrazepam
lsd|
安眠酮|Methaqualone
三唑仑|Triazolam
ghb|
丁丙诺菲|Ding propylene Sanofi
麦司卡林|Mescaline
pcp|
止咳水|Cough syrup
迷幻蘑菇|Magic mushrooms
地西泮|Diazepam
汽狗|Steam dog
射钉枪|Gun
猎枪|Shotgun
手枪|Pistol
沙鹰|Shaheen
仿真枪|Imitation guns
氢化纳|Sodium hydride
氢化钾|Potassium hydride
挂号器|Registration is
广告机|Advertising
骂人机|Curse machine
挂房间软件|Hanging room software
包射|Pack shot
果聊|Fruit chat
362756689|
高仿|High imitation
批发|Wholesale
零售|Retail
edns|
躶体|躶 body
mm52|
全倮|Full Luo
baohua|
不裸|Not bare
e情|E Love
按摩|Massage
治愈|Cure
代开|Behalf
扣|Buckle
优惠|Preferential
79460158|
1134154803|
ｑ|
精准|Precision
做ai|Do ai
aa168|
佣金|Commission
挂人气|Hanging popularity
sowo123|
5ibbb|
包邮|Free shipping
货到付款|Cash on delivery
电脑监控软件|Computer monitoring software
做肛|Do anal
波超大|Large waves
52352278|
窃听器|Bug
迷幻|Psychedelic
迷情|Sensation
1411103586|
862320241|
外来妹|Girls from outside
逼紧|Forced tight
普陀|Putuo
水多|Juicy
独居|Solitary
1259111807|
992456111|
风韵|Charm
口爆|Mouth burst
蒲东妹|Po Dongmei
做缸女|Do tank woman
858616306|
814680633|
648641689|
1466531433|
3580931|
迷情药|Sensation medicine
吞精|Swallow sperm
1354085559|
1350863816|
水嫩mm|Supple MM
517512112|
大乃|Large is
包您满意|Satisfaction Guaranteed
交际花|Socialite
安全期|Rhythm
带t|With T
号器|No device
缸做|Cylinders do
露荫|Lucy Yam
情趣内衣|Sexy lingerie
大波|Big wave
发票|Invoice
漏b|Drain B
1361699775|
佣琻|Commission 琻
15024668933|
胸大|Big chest
高科技眼镜|Tech glasses
广告发送器|Advertising transmitter
徐汇女|Xuhui female
漏乳|Drain milk
騷女|Sao female
骚女|Sao female
騒女|Uproar female
赵鑫磊|Zhao Xinlei
.tk|
ω|
φ|
呱呱|Quack
刘小波|Liu Xiaobo
和平奖|Peace Prize
52开西|52 Open West
国宝小胖|DAVID chubby
刘夫人|Ms. Liu
liuxiaobo|
xiaoboliu|
小波刘|Wavelet Liu
晓波刘|Liu Xiaobo
波晓刘|Liu Xiao wave
刘晓啵|Liu bo
norway|
晓波|Xiaobo
锦州监狱|Jinzhou prison
炸弹奖|Bomb Award
中联办|Liaison
一半将牢底坐穿|Half of which will sit in a hole
一半已照亮黑暗|Half had illuminate the darkness
一半是民|Half of China
一半是主|Half of the main
零八宪 章|And eight Charter
零八宣言|And eight of the Declaration
零八宪法|And eight of the Constitution
天a门|A door day
石天河|Stone Milky Way
郑海天|Zheng Haitian
郭道晖|Guo Daohui
流小饽|Flow small cake
科平奖|Copping Award
刘曉波|Liu Xiaobo
中国的曼德拉|China's Mandela
挪威|Norway
5see|
5see|
5see|
5see|
5see|
jasmine|
看片|Watching films
老b|Old B
马b|Ma B
熊焱|Xiong Yan
杨涛|Yang Tao
张铭|Zhang
学妹|School girl
漏逼|Drain force
露逼|Lu force
抽选|Lottery
新浪公司|SINA Corporation
无辜汉族|Innocent Han
香榭大街|Avenue des Champs
美福大盘鸡|Phuoc Panji
维族警察|Uighur police
多少克|How many grams
多少片|How many pieces
高纯度|High purity
咕噜|Gollum
好货|Good stuff
几百一克|Hundreds of one gram
溜8|Slip 8
平果|Pingguo
丰满|Plump
上门|Visit
高挑|Tall
白净|Fair and clear
火辣|Hot
零八宪|And eight Gazette
黑逼|Black force
求男|Seeking men
小妹|Sister
.info|
q号|Q No.
q1|
q2|
q3|
q4|
q5|
q6|
q7|
q8|
q9|
系q|Department of Q
广场砸车|Square smashed cars
撕扯日本国旗|Tear Japanese flag
日系车被砸|Japanese cars smashed
反日 砸车|Anti-Japan smashed cars
保钓 砸车|Diaoyutai smashed cars
西安游街|Xi'an parade
和讯|And News
guagua|
vv|
guagua|
vv|
sp8|
光聊|Light chat
聊网|Network chat
o光|O Light
o光|o Light
拖光|Drag light
.so|
<|
>|
汇款|Money transfer
聚会|Get together
聚会，集会|Gatherings, rallies
kapir|
kaper|
kiper|
kipir|
kepir|
keper|
mujiahid|
mujahid|
mujehid|
xuar|
shoar|
xuwar|
xowar|
yihilix|
yigilix|
yighilix|
yihilish|
yighilish|
harket|
herket|
herkat|
watendaxlar|
vatandaxlar|
vetendaxlar|
vatendashlar|
vetendashlar|
watandaxlar|
wetendaxlar|
watendashlar|
wetendashlar|
watinimiz|
wetinimiz|
vatinimiz|
vetinimiz|
namayix|
namayish|
namaix|
namaish|
uyhurkurultay|
维吾尔代表大会|Uighur Congress
uyghurkurultay|
uyhurqurultay|
uyghurqurultay|
kixlikhokok|
kixilikhokok|
kixlikhoqoq|
kixlikhokog|
kixlikhoqog|
kishlikhokok|
kishlikhoqoq|
kishlikhokog|
kishlikhoqog|
erkinlik|
erkinlig|
arqinlik|
arkinlig|
mustakillik|
mustaqillik|
mustakilliq|
mustaqilliq|
taxvik|
taxwik|
tashvik|
tashviq|
pilan|
plan|
pilen|
xehit|
shehit|
xayit|
shayit|
xahit|
shahit|
tashkilat|
taxkilat|
texkilat|
teshkilat|
oyhunayli|
oihunayli|
oyhunaili|
oihunaili|
hijrad|
伊吉拉特|Iggy lats
hijred|
hijret|
hijrat|
quralliq|
kurallik|
kuralliq|
qurallik|
topilang|
toplang|
tupilang|
tuplang|
turkista|
tvrkistan|
tvrkvstan|
turkustan|
xitay|
黑塔依（汉人）|Dark Tower according to 
hitay|
rabiye qadir|
热比娅?卡德尔|Rebiya Kadeer? Kadeer
rabiya kadir|
rabiye kadiri|
ezaliri|
ezaliri|
azaliri|
azaleri|
weten|
watan|
waten|
meqset|
maqsat|
mahsat|
mehset|
mahset|
azatliq|
azatlik|
jihad|
jihad|
jihat|
jahat|
jahad|
alaqe|
alaka|
alake|
kuzutus|
kuzutush|
kozutush|
kozitish|
kozitix|
kozutux|
kvzitix|
meslihet|
maslahat|
maslihet|
maslat|
meslet|
maslet|
munapiq|
munapik|
munapek|
hokumet|
hukumet|
hokmat|
hokmet|
hokumat|
hokumet|
qerindash|
kerindax|
kirindax|
partlitish|
partilitix|
partilitish|
partilditish|
partilditix|
awangart|
awangart|
?awangirat|
pexes|
pahas|
pehes|
teshkilat|
muhajir|
muhajir|
axbarat|
ahbarat|
chaqiriq|
chakirik|
qarik|
chaqirik|
hijret|
hejrat|
hejret|
xeter|
hatar|
heter|
tajawuz|
tajawuz|
tajawoz?|
tajawos|
kommunist|
komnist|
komnis|
kominis|
bomba|
bomba|
hezbut|
hezbut|
hizbot|
hizbut|
saqchi|
saqci|
sakqi|
sakchi|
sahqi|
sahchi|
musteqil|
mustakil|
mustekkil|
mustkel|
mustekkel|
herket|
harkat|
harket|
paaliyet|
paaliyat|
palyat|
palyet|
pa'aliyat|
nishan|
nishan|
nixan|
nexan|
burader|
burader|
boradar|
borader|
hakimiyet|
hakimyet|
hakimyat|
hakemyat|
teyyarliq|
tayyarlik|
teyarlik|
haram|
haram|
uqturus|
uhturush|
ukturux|
uhturux|
qarshiliq|
qarxiliq|
karxilik|
karixlik|
karishlik|
karishliq|
yashisun|
yaxisun|
yaxison|
yashison|
dushmen|
duxman|
dvxman|
dvshmen|
doshmen|
doxmen|
tijaret|
tijaret|
tijarat|
emir|
艾米尔|Emile
emir|
amir|
amri|
ishenchilik|
ixanqilik|
eshenchilik|
exanqilik|
weziyet|
weziyet|
waziyat|
xeterlik|
heterlik|
hatarlik|
hatarlek|
basturush|
basturush|
basturux|
qirghinchiliq|
qirghinqilik|
kirginqilik|
kerginqilik|
kergenqilik|
ehtiyat|
ihtiyat|
jundullah|
君都拉|King Abdullah
jundullah|
tebliq|
台比力克|Taiwan than Lectra
teblih|
tablih|
teblik|
tablek|
shehid|
xihit|
xehet|
xehit|
xehed|
xehid|
xahid|
shahit.|
shehit|
qehriman|
qehriman|
kahriman|
kehriman|
qahriman|
kahirman|
qahirman|
qurultay|
qurultay|
kurultay|
nizamname|
nizamname|
nizamnama|
ustaz|
ustaz|
秀吧|Show it
y326|
靓号赢大奖|Liang win prizes
秀b|Show b
秀b|Show B
.run|
eval|
ucim_eval|
乌鲁木齐 游行|Urumqi parade
乌鲁木齐 四点|Urumqi four points
乌市 四点|Urumqi four points
乌市 公园北街|Urumqi North Park
乌市 市政府|Urumqi Municipal
乌市 大十字|Urumqi Grand Cross
乌市 人民广场|Urumqi People's Square
点击进入<|Click to enter
成人奶妈论坛|Adult nurse Forum
奶妈服务中介|Nanny service mediation
成人奶妈网|Adult nurse network
成人奶妈兼职|Adult part-time nanny
提供成人奶妈|Provide adult nurse
成人奶妈招聘|Adult nurse recruitment
哪里有成人奶妈|Where there is an adult nurse
成人奶妈中介网|Adult nanny agency network
奶妈网邀请码|Net nanny invitation code
母乳吧|Breast milk bar
找成人奶妈服务|Looking for nanny services for adults
宇宙|Universe
无敌二次郎|Invincible two Jiro
open|
ucim_open|
submit|
ucim_submit|
evel|
ucim_evel|
showmodelessdialog|
ucim_showmodelessdialog|
noscript|
ucim_noscript|
xinlang！|
623003555|
65874651|
7个娃娃|7 doll
768653857|
1179884886|
2197649807|
换话费|In other calls
1036487772|
834007314|
18602138549|
2851600305|
025-68994902|
136-4515-9685|
285-1600-294|
1071349077|
1953390389|
507207381|
2851600300|
159-519-89300|
请问愿意兼职吗|Will you willing to part-time
15963647538|
2746925503|
2817031394|
2921799681|
2568870735|
2838609613|
483789791|
1845783781|
706730020|
247855484|
506835416|
516099331|
yy3344.ｔk|
小溼逼|Small wet force
583334601|
1369882980|
2373920918|
412677924|
544597437|
400-0457-117|
78291368|
性片|Sheet
379657059|
350923675|
1540803341|
376422931|
1105761878|
93219684|
172170795|
390129097|
qq 1219124180|
yy3344. ｔk|
apec|
apec|
apec会面打伏笔|apec meeting paved the way to play
apec期间找奥巴马|Obama looking for during the APEC
各国安全狙击手|National safety sniper
谋袭apec|Seek passage of APEC
各种舔腚新闻|Various lick Ding News
北京风声鹤唳|Beijing jittery
apec前北京紧张异常|APEC abnormal nervous before Beijing
ucim_apec|
只为洋大人做主|Only for foreign adults shots
isis都盯着的|isis staring at the
一开盛会就无霾|An open event on no haze
恳请老天别媚外|Implore God not capitulation
我党不是做不到|I do not party
婚外性的性体验|Extramarital sexual experience
1627181517|
2492697289|
1727291858|
597173859|
淫乱刺激的乱伦|Stimulate promiscuous incest
5833 34601|
办公室激情|Office of the Passion
15688677|
727251338|
1329414577|
1563034309|
2024805640|
2831550137|
2934712052|
1503856030|
2587436761|
2722430073|
537716353|
2949165910|
2451518208|
335014000|
975447543|
qq 1564776528|
362049300|
981941321|
1095335625|
21945 75616|
qq 2838609613|
ｑ 2568870735|
583334 601|
1449545759|
1809241522|
243227119|
19984322|
1542247236|
2448522913|
17338445|
5 83334601|
790681587|
731849371|
7318493|
yy3344|
159636475|
2805602029|
3052698832|
1134440185|
2909488989|
2409830772|
yy13865420|
2087367425|
2524764960|
6034838|
603483869|
2952059730|
138530166|
1007183826|
724220559|
359865278|
qq 2789928662|
ｑ 2846193622|
648768433|
1792718114|
984482817|
984482|
1720605958|
1728999364|
yy3322.ｔk|
2641615096|
459128469|
1330424807|
148370789|
58995608|
2817317202|
3053554617|
283155o137|
2366582446|
1295103077|
512701312|
459128469|
129510307|
211599645|
2413905696|
3045350860|
58333 4601|
2535229386|
524645580|
9011882|
1 3 3 0 4 2 4 8 0 7|
2113767309|
2293681049|
459128469|
380454642|
2846193622|
284619362|
2 8 3 8 6 0 9 6 1 3|
220504939|
1443678356|
49659527|
3050266780|
2 8 1 7 3 1 7 2 0 2|
331495606|
240838256|
240838256qq|
459128469|
2 5 2 4 7 6 4 9 6 0|
3 3 1 4 9 5 6 0 6|
461858508|
219 4575616|
254764960|
461858508|
461858508|
4618585|
2194575616|
211783693|
21 94575616|
2194 575616|
656606815|
2194575 616|
656606815|
⒉⒋⒐⒉⒍⒐⒎⒉⒏⒐  ⒉⒋⒐⒉⒍⒐⒎⒉⒏⒐|
526563725|
2846193622|
注册登录后试看|Sign Look after
无限制|Unlimited
219457 5616|
2846193622|
2846193622|
792944882|
792944882|
2846193622|
21945756 16|
2846193622|
3050266 780|
1279312670|
秀b美女|B beauty show
男*人*镙*聊|M * person * * Luo chat
2 194575616|
1274213165|
219457561 6|
1253024150|
987328174|
327561793|
964294598|
987328174|
219 4575 616|
2325772008|
635456591|
987328174|
28 3745 7080|
2837 45 7080|
1272093199|
295478682|
dncxz点com|dncxz dot com
1318079172|
3 3 1 4 9 5 6|
2568870735|
273837703|
3039065161！|
c85634|
6096984|
617366773|
232577 20|
372552041|
896732343|
28 37457 080|
2088344911|
89229861|
2837 457 080|
1802443404|
724390723|
1161044894|
1270561559|
28 374570 80|
398955538|
232577 2008|
2950677 370|
694449988|
1309959300|
28 37457080|
1113937240|
2837 457080|
2325 772008|
1810073203|
397134484|
5 0 7 2 0 7 3 8 1|
1330013329|
133001332|
28374 57080|
5 0 7 2 0 7 3 81|
694449988|
406202475|
421464467|
283745 7080|
343908321|
32756179|
3050 266780|
654107108|
283745|
987328174|
821565697|
838419814|
284619362|
372911513|
3083392362|
2837457080|
1295103077|
q 2837457080|
ｑ838419814|
ｑ 16093６６０７|
ｑ838419814！|
3314956|
1609366079|
18629852342|
67367162|
193400945|
85143173|
90474841|
244265491|
2723882775|
1540442625|
5833346 01|
58 3334601|
1609366079|
13300 13329|
1454302462|
772053060|
2814124480|
446391947|
2053788306|
2741033944|
459128469|
466267846|
411036979|
2485227235|
734564324|
627104001|
584083152|
5246455|
307021052|
270966025|
948974703|
3129469609|
025-84638589|
281838649|
165120762|
1031603551|
2851600303|
176383447|
705516508|
2629026697|
474301396|
1609366079|
2485227|
434503260|
420409227|
1835295756|
129510307|
4618585|
1296043479|
35092367 5|
377856433|
461858508|
50065866|
1917792850|
731849371|
792944882|
张明1|Zhang 1
张明2|Zhang 2
张东|Zhang Dong
soundcloud|
mediafire|
ia802701|
onedrive|
islam-tr|
wisalstudio|
muzikkitabi|
albuxoriy|
i-qooqaz|
blogspot|
qmp3music|
jundurrahmon|
kedirijaya|
16093 66079|
1609366079|
：：1835295756|
ｑ 858145895|
921155253|
178405352|
1609366079|
1817923185|
138530 166|
254142152|
376517546|
858145895|
1609366079|
631793811|
3047851337|
172307500|
85814589|
1609366079|
2541421520|
932128855|
1609 366079|
642347460|
1609366079|
534300207|
858145895|
18352957|
7055 16508|
209843785|
2106727074|
9 2 1 9 9 0 9 5 7|
209549981|
675304909|
2106 727 074|
shabakataljahad|
vimeo|
dropbox|
mvlse|
freelibs|
4shared|
pcloud|
spaces|
hotfiletrend|
kalbsadasi|
fg2020|
zynvar|
zscnyxd|
zohxl|
zmwxd|
zi6k|
zg6f|
zdvzs|
yvvjqmv|
y2me|
xzxvxow|
xzxhhu|
xs3q|
xlzaa|
xing8ke|
xfaqw|
xdtfhcx|
webgy5|
waghnk|
vvxezma|
vtfuer|
vdlhfvw|
uyifyf|
tzyywp|
tzw2|
rzu0|
rz7g|
rgeux|
rdyxgx|
qqw88|
qbotgja|
pucdphf|
psoyiqs|
p3wk|
ohrpzf|
nhqmk|
ngyilh|
nephv|
n6ed|
mtyuyq|
meolr|
maiqiang54|
m4ds|
lzo2|
luevmyj|
lsjgs1|
lkvlxiv|
lfvhknw|
lffxc|
lejtm|
lczzwty|
lbonw|
l18o|
kxrysk|
kwcqxap|
khaiv|
k670|
jtglw|
jjwdnm|
jicrlul|
j98f|
hssafe|
glccvq|
fikhrq|
esakfg|
epvgmy|
egxwwzh|
ecmxxg|
dwjurw|
dvckaa|
dsmfplr|
dsfdlfds|
dquaok|
dqckpih|
dpvlrjr|
dpszq|
dnppgv|
dltgzzi|
dllknn|
digfuf|
difkr|
dhyipos|
dfwplb|
dflpl41|
danfzl|
czwjiwfz|
czsmfr|
cxthmct|
cuichengfei|
cu4c|
csbzips|
crzhsga|
cqzhuq|
coucbi|
cnliuting|
cmjeqz|
chubk88|
chinard|
china7yt|
chengyanyane|
cgblt|
cgb9|
cfqwr48|
cdwjyj|
cclry8|
bvhqgh|
bsdmnz|
bpomwhd|
bnhjobg|
blolvg|
bldyulecheng06|
bjkbr|
bhhok|
baifuhuaqpk|
azxtky|
aumxln|
atxhi|
atluyle|
asissf|
aqeoax|
anbin|
amszt|
alwcrf|
ajpnie|
aglqsec|
abldror|
91w91|
8zpn|
7y0u|
654kcp99|
5ex1|
al8i3g|
zzvhxe|
zwkak|
zr5i|
zpxka|
zplswy|
znfmq|
zksot|
z8y0|
ywiy|
ymxfnu|
ylrgtd|
xuthkr|
xuiku|
xswhkky|
xriwp|
xoqgiy|
xnpzn|
xlohd|
xihvea|
xdwj|
xdlgn|
xcytga|
xaqhpg|
x9z|
wzfna|
wufeip6|
wtmlei|
wnsyi|
wlyqyy|
wifdl|
wiegagn|
whpffe|
webub|
websrff|
webs9x|
webf2|
webe5c|
webe4a|
webdewl|
wbqyb|
wagr|
w58c|
w0ni|
vsbtnm|
vrjl|
vrdgw|
vmeokyr|
vjbiz|
vfpnine|
vejtcv|
vczycaf|
v6n|
uylla|
uwsauuq|
utuejg|
uovpn|
uelngz|
uczfbqri|
ubacr|
u1sd|
u0zi|
txnplo|
ttvwr|
tszxa|
tqmca|
tjkhpxe|
tjdknqb|
tigjgr|
svqifq|
suplj|
stlkfjsl|
sithoc|
sgmrys|
se24|
s4j6|
ryqao|
rspdcch|
rlbzw|
rhy5|
rggtq|
qxykp|
quhvt|
qjarj|
qiqiang369|
qfuth|
pxgzi|
pvoaz|
pvffm|
pttuqa|
ptgbbrjp|
ptaedp|
ppvqc|
poglw|
pandnc|
p5n7|
ozucc|
opozfm|
okvlcgc|
offmn|
ocmhq|
obdbcq|
oajou|
o6nn|
nzngx|
nuiot|
npwsje|
npdnrk|
nnwopm|
nkma|
niwffo|
niulm|
niaoqiqiang|
nhphfp|
nc5w|
mvmoi|
mm360mm360|
mlydo|
mlrvm|
meyacj|
maxiak|
lyovm|
luwgie|
luchangfufgh|
ltbzp|
lrosys|
lkqx|
ldnusn|
kzfdjx|
kvadutwn|
ksqtbqm|
kqoio|
k2du|
jxxt|
jxthig|
jvjxme|
jtzfauy|
jrxkc|
jpyab|
jmngo|
jkoty|
jivsn|
jhrol|
jgirt|
jbodpna|
319316413|
1609366079|
208298029|
9 2 1 9 9 0 9|
210 672 7074|
739322867|
7393228|
858145895|
2192678860|
大纪元，博讯|The Epoch Times, Boxun
282042707|
921155253 ！|
2216043648|
348883393|
705823020|
24913591  ！|
2491359197|
1609366079|
1609366079|
1609366079|
1371053887|
3185770249|
862267611|
634461641|
2934611477|
603483869|
603483869|
1050892792|
中央权力分布图|Central power distribution
习猪头|Xi dude
贾廷安|Jia Yanan
1261953778|
汉奸|Traitor
毛邓江|Mao Dengjiang
落马官员|Officials sacked
刀把子|Dao child
高度集权|Highly centralized
衣俊卿|Yi Junqing
李海进|Lee feed
性骚扰|Sexual harassment
党内清洗|Party Cleaning
阻碍清查|Hinder inventory
张伟杰|Zhang Weijie
通奸党|Adultery party
杨卫泽|Yang
斯大林式|Stalinist
a peaceful war|
挥霍中华|China squandered
齐桥桥|Qi Bridge
.ga|
603483869|
1330002340|
q 16093６6079|
1330002340|
769734454|
2842084107|
1660279749|
603483869|
7 05516508|
2805 324924|
2996797158|
133567 57098|
62300 3555|
3044265731|
257809120|
1583985525|
2 0 8 7 3 6 7 4 2 5|
603483869|
1677970623|
562950970|
3013982627|
859817541|
25780912|
255733154|
583985525|
28053 24924|
59817541|
2 0- 8 7 -3- 6 7- 4|
1526619300|
9  2  1  9  9  0  9  5  7|
2805324924|
2557331547|
1609366079|
2541 421520|
w w w . y 8 8 8 . g|
841998731|
2814509835|
737145382|
1609366079|
28145 09835|
1610461483|
w w w . s 8 8|
1160629606|
844385014|
745174825|
934386398|
1192994828|
281 7317202|
411106658|
习二夶|Xi two 夶
3065736072|
28461 93622|
w w w . s 8 8 8 . g a|
1609366079|
w w w . y 6 8 8 . g a|
1609366079|
635949363|
2503216805|
2817 317202|
w w w . y 6 8|
281450 9835|
1609366079|
w w w . e 7 7 8|
w w w .y 3 8 8|
//weak_supervision=3|
//person_count=1|
八九学潮|Eighty-nine student protests
包..射|Package .. shoot
黄se电影|Huang se movie
脱衣自卫|Strip of self-defense
倮 聊|Luo chat
斗鱼tv|Betta TV
斗鱼直播|Betta live
专业弓弩网|Professional crossbows network
出售雷管|Sale detonator
出售雷管 qq|QQ detonator sale
出售 炸药|Sell ​​explosives
出售炸药|Sell ​​explosives
叶城幸福路|Yecheng Xingfu Road
制作火药配方|Making gunpowder recipes
炸药出售|Sell ​​explosives
出售雷管炸药|Sell ​​explosives detonator
火药配方|Gunpowder formula
在家里做原子弹|Atomic bomb at home
tnt 炸弹的制作|TNT bomb making
硝铵炸药配方|Explosive Recipe
硝酸甘油制作|Nitroglycerin Production
炸弹配方|Bomb Recipe
简易炸药|Simple explosives
炸弹制作|Bomb-making
起爆器　制作|Detonator production
燃烧弹 制造|Incendiary Manufacturing
弹药制造方法|Ammunition manufacturing method
液体炸药配方|Liquid explosives recipe
炸药配方与制作|Formulation and production of explosives
自制炸药配方|Homemade explosive formulation
tnt炸药成分|tnt explosive ingredients
炸药的制作|Production of explosives
tnt炸药配方|tnt dynamite recipe
炸药的成分|Components of explosives
燃烧弹的制作方|Incendiary producers
黑火药的配方|Black powder formulations
黑火药的制作|Black powder production
黑火药比例|The proportion of black powder
燃烧弹 制作|Making incendiary
黑火药配方比例|The proportion of black powder formula
黑火药的成分|Black powder ingredients
原子弹配方|Bomb recipes
雷管出售|Detonator sale
制作硝化甘油|Making nitroglycerine
diy核弹|DIY bomb
核弹制作方法|Bomb production methods
原子弹制作手册|Bomb making manuals
简易原子弹教程|Simple tutorial bomb
黑火药配方|Black powder formulations
自制炸药方法|Homemade explosives method
zz炸弹的制作方法|zz bomb production methods
c4炸药的成分|Component C4 explosives
「红烧兔子」大餐|"Braised rabbit 'dinner
汽车炸弹制作|Car bomb-making
共贪党|Total greedy party
鸡尾酒炸弹制作|Cocktail bomb-making
集束炸弹制作|Production of cluster bombs
莫洛托夫燃烧弹|Molotov cocktails
塑胶炸弹|Plastic Bomb
用火药混合塑料|With gunpowder mixed plastics
zha药制造进程|Zha drug manufacturing process
购买自爆材料|Buy blew Materials
c4塑胶炸药|C4 plastic explosives
水浴法制tnt|Legal TNT bath
如何制硝化甘油|How to make nitroglycerine
简易大威力炸弹|Easy big powerful bomb
炸弹制作入门|Getting Started with bomb-making
酸甘油炸药|Nitroglycerin dynamite
简易导弹制作|Easy missile production
核弹头的制造|Manufacture of nuclear warheads
可塑炸弹制作|Plastic bomb-making
原子弹制作方法|Atomic bomb production methods
火药的配方|Gunpowder recipe
手教你做原子弹|Hand teach you to do the atomic bomb
怎么自制燃烧弹|How Molotov cocktail
tnt炸弹制作|TNT bomb-making
教你制作原子弹|Teach you to create the atomic bomb
diy原子弹|DIY bomb
原子弹制作|Bomb making
atom弹制造|ATOM bomb manufacturing
火药原理|Gunpowder principle
简易炸弹|IED
简易燃烧弹|Simple incendiary
土炸药成份|Soil explosive ingredients
燃烧弹制作|Making incendiary
炸药的制作配方|Explosives Recipes
炸药的配方|Dynamite recipe
如何自制燃烧弹|How Molotov cocktail
标准炸弹教程|Standard bomb Tutorials
制作炸弹首先要|Bomb-making first
燃烧瓶制作|Making Molotov cocktails
出售炸药qq|QQ sell explosives
出售气枪|Sell ​​airguns
出售气枪 qq|QQ sell airguns
出售气枪 电话|Sell ​​airguns phone
出售手枪 qq|QQ pistol sale
出售手枪 电话|Sale pistol phone
出售猎枪|Shotgun for sale
出售猎枪 qq|QQ shotgun for sale
出售猎枪 电话|Shotgun phone sale
出售汽枪|Sell ​​air guns
出售步枪|Rifle for sale
出售狙击枪|Sell ​​sniper rifle
出售手狗|Hand dog sale
出售气狗|Sell ​​gas dog
出售猎狗|Dogs for sale
64式手枪出售|Type 64 pistol for sale
92式手枪出售|92 pistol for sale
出售:高仿真枪|For Sale: High imitation guns
出售54式手枪|Type 54 pistol for sale
出售m1911|M1911 for sale
出售各类猎狗|Sell ​​all kinds of dogs
出售仿真枪|Sell ​​imitation guns
出售外国枪模|Sale of foreign gun mode
出售袖珍手枪|Pocket pistol for sale
娥眉气枪出售|Crescent sell airguns
防身手枪qq|Defensive Pistol QQ
防身武器手枪|Pistol for self-defense weapon
仿真枪qq|QQ imitation guns
高压狗qq|Hyperbaric dog QQ
高压气枪|High pressure air gun
气枪子弹|Airgun bullets
高压气枪专卖店|High pressure air gun store
各类军用枪|Various types of military guns
各类军用枪支|Various types of military firearms
各式气枪出售|Sell ​​all kinds of airguns
工字汽狗麻醉枪|Steam word dog tranquilizer gun
供应军用手枪|Supply of military pistol
供应汽枪|Supply air guns
购买枪支qq|QQ buy guns
集团出售手枪|Group sold a pistol
进口气枪|Imported air gun
军用54出售|54 military sale
军用77出售|77 military sale
军用手枪钢珠枪|Military pistol ball gun
里有汽枪出售|There are air guns for sale
猎枪出售/枪|Shotguns for sale / gun
猎枪仿真枪qq|QQ imitation guns shotgun
猎枪哪里有卖|Where to sell shotgun
猎枪手枪买卖|Shotgun pistol sale
猎枪专卖店|Shotgun stores
麻醉枪猎枪军用|Tranquilizer gun shotgun military
买卖54狗|The sale of 54 dogs
买卖64狗|The sale of 64 dogs
买卖警察枪支|Trading police firearms
买卖军狗|Army dog ​​sale
买卖军用枪支|The sale of military firearms
卖64手枪|Sell ​​64 pistol
卖92手枪|Sell ​​92 pistol
卖钢珠枪qq|Sell ​​QQ ball gun
哪里有钢珠枪|Where ball gun
哪里有卖双管猎|Where to sell double-barreled hunting
哪里有气枪卖|Where to sell airguns
哪里有枪出售|Where there is a gun for sale
哪里有真枪出售|Where there is genuine sale
哪里有真枪卖买|Where there is genuine sale and purchase
哪能买到真枪|Where can I buy genuine
气狗 高压气枪|Gas high pressure air gun dog
气枪专卖网|Airsoft monopoly network
气枪仿真枪出售|Airsoft replica guns for sale
气枪货到付款|Airsoft Delivery
汽狗出售|Steam dog sale
气枪专卖店|Airsoft Store
气枪看货加qq|Airsoft see the goods plus QQ
气枪联系qq|Airsoft Contact QQ
气枪猎枪麻醉枪|Airsoft shotguns tranquilizer gun
气枪迷魂药|Airsoft Ecstasy
汽狗高压汽枪|Steam high pressure steam gun dog
热武器qq|Thermal weapon QQ
三箭气枪出售|Three arrows sell airguns
手枪气* 枪猎|* Air gun hunting pistol
售枪购买手枪|Buy pistol gun sale
售手枪qq|QQ pistol sale
提供气狗专卖店|Provide air dog store
锡峰气枪出售|Tin peak airgun sale
仙鹤气枪出售|Crane airgun for sale
销售电手狗|Sales electric hand dog
销售气手狗|Sales gas hand dog
销售小口径步枪|Sales of small-caliber rifle
销售运动步枪|Sales sporting rifle
小口径秃鹰沙漠|Small caliber desert vultures
有军用枪支出售|There are military firearms for sale
长期出 售手枪|Long-term sale pistol
折叠狗qq|Folding dog QQ
转让 猎枪|Shotguns for sale
子弹货到付款|Bullet Delivery
自制手枪哪里买|Where to buy homemade pistol
组装手枪|Assembled pistol
最新销售汽狗|Sell ​​Steam dog
猎枪|真枪|Shotgun | genuine
手枪|阻击枪|Pistol | sniper rifle
弓弩专营|Crossbow franchise
弓弩专卖网|Crossbow monopoly network
弓弩专卖店网|Crossbow store network
弓弩专卖店|Crossbow stores
弓弩专卖|Monopoly crossbow
弓弩制作|Crossbow production
弓弩直销|Direct crossbow
弓弩有限公司|Crossbow Ltd.
弓弩营销中心|Crossbow Marketing Center
弓弩一百专卖店|Crossbow one hundred stores
弓弩销售|Crossbow sales
弓弩网|Crossbow Network
弓弩图纸|Drawings crossbow
弓弩特许经销|Crossbow franchise
弓弩狩猎网|Crossbow hunting Network
自制手弩|Homemade hand crossbow
中国弩弓专卖|Chinese crossbow Monopoly
中国弓弩专卖网|Chinese crossbow monopoly network
中国弓弩直销|China Direct crossbow
中国弓弩网|Chinese crossbow Network
中国弓弩狩猎网|Chinese crossbow hunting Network
中国弓驽网|Chinese bow Nu Network
制作简易弓弩|Making simple crossbow
郑州弓弩专卖|Zhengzhou crossbow Monopoly
赵氏弓弩专卖店|Zhao crossbow stores
赵氏弓弩专卖|Zhao crossbow Monopoly
赵氏弓弩销售|Zhao crossbow sales
小型弓弩专卖店|Small stores crossbow
小猎人弓弩网|Small hunter crossbow network
狩猎器材弓弩|Crossbow hunting equipment
狩猎弓弩专卖网|Hunting crossbow monopoly network
狩猎弓弩专卖|Monopoly crossbow hunting
狩猎弓弩麻醉箭|Anesthesia hunting crossbow arrow
三利达弓弩直营|Direct crossbow three LEADER
三利达弓弩配件|Three Lida crossbow accessories
三步倒药箭批发|Three steps down arrow wholesale drug
三步倒弩箭专卖|Three steps down the bolt Monopoly
三步倒麻醉箭|Three steps down arrows anesthesia
三步倒捕狗药|Three steps down to catch drug dog
军用弓弩专卖网|Military crossbow monopoly network
军用弓弩专卖店|Military crossbow stores
军用弓弩批发|Wholesale military crossbow
军用弓弩公司|Military crossbow company
供应秦氏弓弩|Supply Qin crossbow
供应弩用麻醉箭|Supply crossbow arrow with anesthesia
供应弩捕狗箭|Supply Nubugoujian
供应麻醉箭批发|Wholesale supply of narcotic Arrow
供应麻醉箭|Supply anesthesia Arrow
供应精品弓弩|Supply of quality crossbow
供应弓弩麻醉箭|Anesthesia supply crossbow arrow
供应弓弩|Supply crossbow
供应钢珠弓弩|Supply ball crossbow
弓弩商城专卖|Crossbow Mall Monopoly
弓弩商城|Crossbow Mall
弓弩批发|Wholesale crossbow
弓弩麻醉箭|Anesthesia crossbow arrow
弓弩麻醉镖|Anesthetic dart crossbow
弓弩论坛|Crossbow Forum
钢珠弓弩专卖网|Ball crossbow monopoly network
钢珠弓弩专卖店|Ball crossbow stores
打狗弓弩三步倒|Dog crossbow three steps down
麻醉弓弩专卖店|Anesthesia crossbow stores
出售军刀|Sabres sale
出售军刺|Shanker sale
出售弹簧刀|Sell ​​switchblade
出售三棱刀|Tri knife sale
出售跳刀|Jump knife sale
军刀网|Sabres net
南方军刀网|Southern saber Network
户外军刀网|Outdoor Sabres net
三棱军刺专卖|Tri Shanker Monopoly
出售开山刀军刺|Sell ​​machetes Shanker
西点军刀网|West Point saber Network
军刀专 卖|Saber designed to sell
戈博军刀|Gebo saber
阿兰德龙户外|Alain Delon Outdoor
出售军品军刀|Sell ​​military saber
勃朗宁军刀|Browning Saber
军刀军品网|Saber military network
出售军刺军刀|Shanker Sabres sale
警用刀具出售|Police with knives for sale
折刀专卖网|Jackknife monopoly network
阳江军品军刀网|Yangjiang military saber Network
野营刀专卖|Camping knife monopoly
军刀专卖军刺|Saber monopoly Shanker
军刀图片砍刀|Pictures machete knife
军刀网军刀专卖|Saber Saber monopoly network
军品军刺网|Military Army gillnet
军刀军刺甩棍|Saber Shanker rejection stick
阳江刀具批发网|Yangjiang Tool Wholesale
北方先锋军刀|Northern Pioneer saber
正品军刺出售|Genuine Shanker sale
开山刀砍刀出售|Jungle knife knifed sale
仿品军刺出售|Shanker sell imitation products
军刀直刀专卖|Saber straight knife monopoly
手工猎刀专卖|Monopoly handmade hunting knife
自动跳刀专卖|Automatic jump knife monopoly
军刀电棍销售|Saber electric batons sales
军刀甩棍销售|Saber rejection stick sales
美国军刀出售|US saber sale
极端武力折刀|Extreme force knife
阿兰德龙野营刀|Alain Delon camping knife
仿品军刺网|Imitation military gillnets
中国户外刀具网|China Outdoor Network Tool
西点军品军刀网|West Point military saber Network
野营开山刀军刺|Camping machete Shanker
三利达弓弩军刀|Three LEADER crossbow saber
尼泊尔军刀出售|Nepal saber sale
防卫棍刀出售|Defense stick knife sale
防卫甩棍出售|Defense rejection stick for sale
防卫电棍出售|Defense electric batons for sale
战术军刀出售|Tactical saber sale
刺刀专卖网|Bayonet monopoly network
户外军刀出售|Outdoor saber sale
阳江刀具直销网|Yangjiang Tool Direct
冷钢刀具直销网|Cold Steel Tool Direct
防卫刀具直销网|Defense Tool Direct
极端武力直销网|Direct extreme force
刀具直销网|Tool Direct
军刀直销网|Direct saber
直刀匕首直销网|Direct dagger straight knife
军刀匕首直销网|Direct saber dagger
折刀砍刀军品网|Machete knife military network
野营刀具军品网|Camping Tool military network
阳江刀具军品网|Yangjiang Tool military network
冷钢刀具军品网|Cold Steel knives military network
防卫刀具军品网|Defense military network tool
极端武力军品网|Extreme Wu Lijun Commodities network
军用刀具军品网|Military Tool military network
军刀直刀军品网|Saber straight knife military network
折刀砍刀专卖|Monopoly machete knife
野营刀具专卖|Camping Tool Monopoly
阳江刀具专卖|Yangjiang tool Monopoly
冷钢刀具专卖|Cold Steel knives Monopoly
防卫刀具专卖|Defense Tool Monopoly
八*九*学*潮|Eight * nine * learn * tide
学生运动|Student movement
89年6月4日|4 June 1989
六&四|Six & four
民主和专制|Democracy and autocracy
四二七游行|Four hundred twenty-seven parade
绝食请愿|Hunger petition
21名骨干学生|21 key student
天安门母亲运动|Tiananmen Mothers
天下蒙古人|World Mongolians
大游行|Parade
yy-duo|
hack-dw|
抓捕陈光诚亲友|Chen's relatives arrested
yydvowan|
yy-kefu|
yyheima|
vip-duowan|
yy-qun|
duowan-yy|
dwyy2010|
yybk2008|
yyst2010|
反通|Anti-pass
2582097448|
2324374740|
出售防身武器|Sale of self-defense weapon
催情药|Aphrodisiac
钢珠枪|Ball gun
各式气狗|All kinds of gas dog
军用手狗|Army dog ​​hand
军用手枪|Military pistol
共 产 党|Communist Party
共產黨|Communist party
共 產 黨|Communist Party
反日游行|Anti-Japanese demonstrations
抗日-抵制日货|Anti-Japanese - boycott
撑粤语|Cantonese support
漯聊|Luo chat
粿聊|Cake chat
裸聊室|Nude chat room
一夜情交友|One Night Stand Dating
和美女裸聊|And beautiful nude chat
裸 聊|Nude chat
激情騷麥|Sao Mai passion
激情骚麦|Sao Mai passion
激情視頻|Passion video
激情電話|Passion Phone
激情电话|Passion Phone
網絡激情電話|Passion telephone network
網絡電話|Internet telephony
黄色电影|Yellow Film
裸  聊|Nude chat
裸.聊|Naked. Chat
裸露聊天|Exposed chat
躶聊|躶 chat
裸/聊|Bare / chat
搔，麦|Scratch, wheat
騒麦|Uproar wheat
裸-聊|Bare - chat
轮 女干|Round female dry
搔-麦|Scratch - wheat
包-射|Package - shot
視頻衤果聊|Video Yi fruit chat
躶舞視頻|躶 dance video
让她.叫.床|Let her call. Bed
叫`春|Called `spring
激`情 瘙`麦|`` Feeling excited Shatter wheat
包你射|Pack your shot
臊-麦|Bashfulness - wheat
包妳射|U shoot package
女.优|Female. Excellent
口..交|AC outlet ..
乱..伦|Fallon chaos ..
翘臀奶白|Bottom cream
浪逼|Wave force
搔.麦|Scratch. Wheat
包.妳.射|Package. U. Shooting
艹.b|Lv .B
精.液|Fine. Liquid
乳.大.逼.痒|Milk big. Force. Itch
包。射|Package. Shoot
淫音|Kinky tone
q515802750|
激。情裸，聊|Shock. Love nude, chat
乳交|Milk delivery
扣b|Button B
骚ｂ|Sao B
性接待|Of reception
呻.吟.叫.春|Groan. Yin. Called. Spring
浪.叫|Waves. Call
翘臀|Bottom
呻.吟.激.情|Groan. Yin. Excited. Love
包－射|Package - shot
黄~片|Huang ~ piece
不~黄死全家|Not ~ yellow dead family
打.飞.机|Play. Fly. Machine
叫.床|Called Beds
黄^片|^ Yellow piece
不^黄 死全家|^ No yellow dead family
黄の片|There are yellow tablets
不の黄死全家|There are no yellow dead family
浪b|Wave B
黄，色，电影|Yellow, color, movies
叫，床|Called bed
口~交|Mouth ~ AC
激~情 搔~麦|~ Love ~ Mai excited scratch
叫~春|Called ~ Spring
艹b|Lv B
騒.b|.B Uproar
躶舞|躶 dance
包--射|Package - shot
艹ｂ|Lv B
黄死全家|Yellow dead family
簧.片|Spring. Piece
不黄骗你死全家|Do not lie to you dead family Huang
包--.射|Package - shot
做.爱|Make love
乳大逼痒|Rudabiyang
包#射|Pack # shoot
翘。臀.奶。白|Alice. Buttocks. Milk. White
浪。逼|Waves. Force
包。身寸|Package. Body inch
大.騒.货|Great. Uproar. Goods
浪.b|Lang .B
舌舔龟头|Tongue licking glans
叫.春|Called in spring
3.秒.必.射|3 seconds will. Shooting
3。秒。必。射|3. Sec. Will. Shoot
3．秒．必．射|3. Sec. Will. Shoot
骗子死全家|Liar dead family
骚货浪妞|Niu Lang tart
騒货浪妞|Saohuolangniu
骚货浪b|Tart wave B
騒货浪b|Cargo uproar wave B
被！破!处!|Be! Break! At!
三-秒-必-射|Three - seconds - must - shot
叫--床|Called - bed
叫--春|Called - Spring
搔/麦|Scratch / wheat
被。女干|Is. Female dry
舔阴.唇|Cunnilingus. Lip
翘。臀.奶、白|Alice. Buttocks. Milk, white
搔、逼|Scratch, forcing
叫---床|--- Called bed
叫---春|--- Called Spring
黄、片|Yellow, tablets
黄／色／大／片|Yellow / Black / Large / piece
强。女干|Strong. Female dry
ａ。片|A. Sheet
黄|片|Huang | piece
３秒射|3 seconds shooting
被.女干|By Female dry
脱依舞|According to dance off
脱依|Off according to
举报者死全家|Whistleblower dead family
艹屄|Lv cunt
叫=床=叫=春|Called called = = = bed spring
举报者死爹死妈|Whistleblower dead father dead mother
（叫）床（叫）春| bed  Spring
巨。乳|Giant. Milk
扣。b|Buckle. B
扣.b|Buckle .B
扣。ｂ|Buckle. B
（叫）（床）| 
（叫）（春）| 
（露）（乳）| 
露。乳|Dew. Milk
轮.女干|Round Female dry
曰本黄片|Huang said  this   piece
<乳>头|<Milk> header
做<爱>|Do <love>
扣｀逼|`Buckle force
叫｀床|Called `bed
验逼|Inspection force
猛操|Meng parade
摸。奶|Touch. Milk
摸.奶|Touch. Milk
验。逼|Experience. Force
验.逼|Experience. Force
叫}床|Called} bed
叫}春|Spring called}
包}射|Pack shot}
大（乳）|Large 
骚=麦|Sao Mai =
扣=b|Buckle = b
[叫[床]|[Called [bed]
抠～ｂ|Pull ~ B
400-629-1998|
惊喜奖金|Surprise bonus
系 统 信 息|Information systems
400-628-3607|
浓情感恩季|Passion Thanksgiving season
冰毒送货上门|Ice delivery
服务费专家号|Service fee of experts
代挂专家号|The number of experts on behalf of hanging
特需号来电|No need to call special
医院代挂号|Hospital on behalf of registered
医院代客挂号|Hospital Valet registered
挂号服务公司|Registration service company
白小姐特码|Miss Bai special code
博彩乐透乐|Betting Lotto music
六合彩公司|Mark Six companies
曾道人特码|Zeng Daoren special code
赌风暴疾|Gambling storm illness
真钱梭哈|Real money Stud
六合採|Kuni mining
曾道人白小姐|Zeng Daoren Miss Bai
六合彩特码|Mark Six special code
六合彩资料图库|Mark Six Gallery Profile
六合同彩开奖|Six color lottery contract
平码三中三|Code three in three levels
特码开奖|Special code lottery
特码六合彩|Mark Six special code
办警察证qq|Do police certificate QQ
现金百家乐|Cash Baccarat
现金斗地主|Cash Landlords
现金梭哈|Cash Stud
豪乳激情|Haoru passion
香港三中三|Hong Kong's three in three
在线百家乐|Online Baccarat
在线现金博彩|Online Cash Betting
真钱斗地主|Landlords real money
真钱棋牌游戏|Real money chess game
真人赌博网站|Live gambling sites
办假二代身份证|Do fake second generation ID card
专业打手公司|Professional thugs company
代理绑架|Acting kidnapping
代理报仇|Acting revenge
砍人一刀收费|Knives to injure knife charges
代理毁容|Acting disfigured
代理砍人|Acting knives to injure
代理了仇|Acting hatred
代理追债|Debt collection agents
代理地下保安|Acting underground security
代理地下警|Acting Superintendent Underground
代理解决情敌|Agents resolve rival
代理解决小三|Acting solve small three
制造特殊死亡|Manufacture of special death
制造意外死亡|Manufacturing accidental death
制造意外消失|Manufacturing unexpectedly disappear
专业绑架电话|Professional kidnapped phone
专业报仇电话|Professional revenge Phone
专业砍人电话|Professional knives to injure phone
专业了仇电话|Professional of hatred phone
专业追债电话|Professional debt collection phone
专业帮人追债|Professional help people dunning
专业帮人报仇|Professional help people to avenge
专业帮人了仇|Professional help people of hatred
专业帮人清债|Professional help people to clear debt
专业退伍兵打手|Professional Veterans thugs
出售易容面具|Masks for sale Disguise
销售高仿人皮|Sales of high imitation of human skin
出售人皮面具|Sale of human skin mask
供应人皮面具|Supply of human skin mask
正规医院卖肾|Regular hospital Maishen
收购心脏瓣膜|Acquired heart valve
收购肾脏|Acquisition kidney
出售眼角膜|Sale cornea
长期收购肾源|Long-term acquisition of a kidney
长期收购眼角膜|Long-term acquisition of the cornea
肾源肝源中介|Liver and kidney intermediary source
肾源价格qq|Kidney price QQ
肾源中介|Kidney intermediary
肾源提供中介|Kidneys provide intermediary
提供肾源qq|Provide a kidney QQ
高价送养宝宝|High Adopted Baby
高价领养宝宝|High adoption baby
高价出售宝宝|Higher price baby
高价送养孩子|Adopted children at high prices
高价领养孩子|Expensive to adopt a child
高价出售孩子|Children at a higher price
骨髓源出售|Bone marrow-derived sale
骨髓源专卖|Bone marrow-derived Monopoly
qq卖肾|QQ Maishen
成人卖肾|Adult Maishen
售仿真脸皮|Simulation skinned sale
售仿真面皮|Simulation dough sale
售仿真人皮|The sale of simulation of human skin
出售肺脏|Sale lungs
出售肝源|Source liver sale
出售肝臟|Liver sale
售高仿脸皮|Sell ​​high imitation nerve
售高仿面皮|Sell ​​high imitation dough
售高仿人皮|Sell ​​high imitation of human skin
售高仿真面具|High simulation mask sale
出售骨髓|Bone marrow sale
售硅胶脸皮|Silicone skinned sale
售硅胶面皮|Silicone pastry sale
售硅胶人皮|Silicone sale of human skin
售甲状旁腺|Parathyroid sale
进口硅胶脸皮|Imported silicone nerve
进口硅胶面具|Imported silicone mask
进口硅胶面皮|Imported silicone dough
进口硅胶人皮|Imported Silicone human skin
出售人骨|The sale of human bones
出售人体胎盘|Selling human placenta
出售人造脸皮|Artificial nerve sale
出售人造面皮|Sell ​​artificial dough
出售乳胶脸皮|Latex skinned sale
出售乳胶面皮|Sell ​​latex dough
出售乳胶人皮|Latex sale of human skin
出售肾源|Sell ​​a kidney
肾源专卖|Kidney Monopoly
出售肾脏|Kidney for sale
出售腎源|Sell ​​a kidney
出售腎脏|Kidney for sale
出售小肠|The sale of the small intestine
出售心脏|Heart for sale
出售胰腺|The sale of the pancreas
弹簧人皮qq|Springs of human skin QQ
订制人皮面具|Custom mask of human skin
批发海洛因|Wholesale heroin
批发冰毒|Wholesale Ice
少女迷幻药|Girls Ecstasy
qq供应冰毒|qq supply methamphetamine
冰毒配方|Meth Recipe
出售钻石冰毒|Sell ​​diamonds Ice
冰毒制作|Methamphetamine production
冰毒qq送货|Ice Delivery qq
冰毒出售|Methamphetamine for sale
海诺因出售|Heino the sale
氯胺酮出售|Ketamine sale
青蒿素出售|Artemisinin sale
搖頭丸出售|Ecstasy for sale
摇头丸出售|Ecstasy for sale
k粉技术|K powder technology
k粉出售|K powder for sale
k粉送货上门|K powder delivery
k粉製作|K flour
qq製作k粉|qq K powder production
白粉技术|White powder technology
白粉教程|Heroin Tutorial
白粉送货上门|Heroin delivery
开锁工具批发|Unlocking tools wholesale
白牙簽|White toothpick
冰砖合成|Ice cream for synthesis
冰砖提炼|Ice cream for refining
纯古出售|Pure Ancient sale
德版ppk供应|German version PPK supply
订购白粉|Order white powder
订购麻古|Order Magu
订购迷魂|Order Ecstasy
订购乙醚|Order ether
供应k粉|Supply of K powder
供应白粉|Supply of white powder
供应胡椒醛|Supply Piperonal
供应甲基可可碱|Supply of methyl theobromine
供应咖啡碱|Supply of caffeine
供应麻古|Supply Ma old
供应麻黄素|Supply of ephedrine
供应麦角酸|Supply lysergic acid
供应迷魂|Supply of Ecstasy
供应三氯化砷|Supply of arsenic trichloride
供应天然咖啡因|Supply of natural caffeine
供应无水咖啡因|Supply of anhydrous caffeine
供应硝酸铊|Supply of thallium nitrate
供应盐酸氯|Supply chloride hydrochloride
供应摇头糖|Supply shake sugar
供应乙醚|Supply of ether
供应罂粟壳|Supply of poppy capsules
合成k粉|K powder synthesis
化学冰牙签|Chemical ice toothpick
黃牙簽|Huang toothpick
麻古技术|Ma old technology
麻古到货|Magu arrival
麻古订购|Ma Ancient Order
麻古果子|Ma old fruit
麻古教程|Ma old Tutorials
麻果货源量大|Ma fruit supply large
麻黄素出货|Ephedrine shipments
麻黄素教程|Ephedrine Tutorials
麻黄素送货上门|Ephedrine delivery
麦角酸技术|Lysergic acid technology
麦角酸送货上门|Lysergic acid delivery
卖high粉|Sell ​​high powder
卖king粉|Sell ​​king powder
卖k粉|Sell ​​K powder
卖黄体酮|Sell ​​progesterone
卖麻黄素|Sell ​​ephedrine
卖麦角酸|Sell ​​lysergic acid
卖鉆石冰合成|Sell ​​synthetic diamond ice
卖神仙水手机|Sell ​​god of water phone
卖水果冰手机|Fruit ice phone
卖摇头糖|Sell ​​shake sugar
迷魂药出货|Ecstasy shipments
迷魂药到货|Ecstasy arrival
迷魂药订购|Ecstasy Order
迷魂药送货上门|Ecstasy delivery
奶油冰合成|Synthetic ice cream
奶油冰提炼|Ice cream refining
批发大冰磚|Wholesale briquette
批发麻谷|Wholesale Magok
批发白粉|Wholesale white powder
批发毒鼠强|Wholesale Tetramine
批发麻黄素|Wholesale ephedrine
批发牙签果子|Wholesale Fruit Toothpick
鉆石冰提炼技术|Diamond Ice refining technology
冰砖提炼技术|Ice cream for refining technology
冰砖合成技术|Ice cream for synthesis
氫化可的松|Hydrocortisone
求购氰化钾|Buying potassium cyanide
求购铊盐|Buy thallium salt
去氧麻黄碱|Methamphetamine
三挫崙|Three fell Lun
三唑侖|Triazolam
神仙水合成|God of water synthesis
神仙水提炼|God of water extraction
神仙糖送货上门|Fairy Sugar delivery
售制毒工具|Drug manufacturing equipment for sale
售ghb水|Sale of GHB water
售k粉|K powder for sale
售白粉|Sale of heroin
售北朝鲜冰|North Korea sold ice
售冰古毒|Sale of ice ancient poison
售冰鉆石教程|Ice Diamond Tutorial sale
售高纯度砒霜|The sale of high-purity arsenic
售黃綠牙籤毒|Yellow-green toothpicks sale poison
售黃麻素|Sale of jute Su
售麻果配方|Sale of hemp fruit recipes
售麦角酸|Sale of lysergic acid
售迷幻藥|Sale of Ecstasy
售鉆石冰教程|Sell ​​diamonds Ice Tutorial
售羟基環戊基|Sale hydroxycyclopentyl
售铊盐|Sale thallium salt
售小冰砖教程|Small ice cream for sale Tutorials
售乙醚|Sale ether
售左旋黃麻素|L sold jute hormone
水果冰提炼|Fruit ice refining
盐羟亚胺出售|Hydroxy imide salt sale
盐酸羟技术转让|Hydroxyzine technology transfer
鹽酸羟亞胺|Hydroxyzine imine
乙醚合成|Ether synthesis
乙醚送货上门|Ether delivery
乙醚提炼|Ether extract
制造缅古|Manufacturing ancient Myanmar
制作冰磚原料|Making ice cream for raw materials
制作k粉|K powder production
制作麻古|Production Ma old
製造緬古|Manufacturing ancient Myanmar
冰砖出货|Briquette shipments
qq订购迷魂粉|QQ Order Ecstasy powder
qq订购迷魂水|QQ Order Ecstasy water
qq订购迷魂药|QQ Order Ecstasy
迷魂粉教程|Ecstasy powder Tutorials
迷魂水教程|Ecstasy Water Tutorial
迷魂药电话|Ecstasy phone
迷魂水电话|Ecstasy Water Phone
迷魂粉电话|Ecstasy pink phone
开锁工具直销|Direct unlock tool
开锁技能培训|Unlock skills training
开锁器材专卖|Unlock equipment Monopoly
力霸干扰王|Rebar interference Wang
買賣汽車攔截器|Interceptor car sale
批发开锁工具|Wholesale unlock tool
车门解码干扰器|Door decoder Jammer
汽车遥控干扰器|Car remote Jammer
汽车遥控解码器|Car remote control decoder
汽车遥控拦截器|Car remote interceptor
汽车遥控屏蔽器|Car remote Jammer
汽车遥控复制器|Car remote control duplicator
车门遥控干扰器|Door Remote Jammer
92位码汽车解码器|92 yards auto decoders
万能开锁器|Universal unlock
銷售干擾器|Sales Jammer
遙控解碼器|Remote Control Decoder
3d网络电视棒|3d network TV stick
全球网络电视棒|Global Network TV Stick
高清网络tv棒|HD network TV stick
高清网络电视棒|HD Network TV Stick
迷你网络电视棒|Mini Network TV Stick
正品电视棒qq|Genuine TV Stick QQ
x卧底出售|X undercover sale
出售監聽王|Wang listening sale
批发监听器|Wholesale Listener
监听器价格|Listeners price
监听器软件下载|Listener software download
批发改號軟件|Wholesale changing Software
负面新闻删除|Delete negative news
各行银行卡出售|Each line of bank cards for sale
售手机变号|The sale of the phone number changed
售手机改号|The sale of the phone number change
售手机卧底|Sale of mobile phones undercover
手機截聽器|Phone interception device
无线窃听器qq|QQ wireless bug
007间谍改良版|007 Spy improved version
007间谍代码|007 spy code
007间谍免费|007 spy free
007間諜改良版|007 Spy improved version
高清针孔摄像头|HD pinhole camera
删除负面帖子|Remove the negative posts
删帖公司|Delete posts
删帖营销公司|Shantie marketing company
收费删帖|Charges delete posts
网络删帖qq|Network delete posts QQ
网络删帖公司|Network delete posts
网络水军qq|Internet Water Army QQ
网络推广删帖|Internet promotion delete posts
公务员代考|Civil-generation test
招聘兼职发帖员|Part-time staff recruitment post
招聘网络水军|Navy recruitment network
专业代理投票|Professional proxy voting
专业删帖服务|Professional services shantie
专业删帖机构|Professional delete posts agencies
专业刷票服务|Professional brush ticket service
专业投票服务|Voting Professional Services
专业网上刷票|Brush professional online ticket
售考试答案|Sale of test answers
出售银行卡|Sale of bank cards
国税《%》地税|Tax "%" rent
办证当面交易|Rush face transactions
台湾版假币qq|Taiwan version counterfeit QQ
代高仿身份证|Generation of high imitation ID
fapiao大量供应|fapiao large supply
qq提供代考服务|QQ provide test taking services
代假冒身份证|Generation of fake ID cards
特码论坛|Special code Forum
转让冒名信用卡|Transfer of bogus credit cards
仿真假钞出售|Simulation sell counterfeit
办理国安证|Handle national security certificate
办证qq|Rush QQ
诚信假身份证|Honesty fake ID
出售钞票|Sell ​​notes
出售四级答案|Sold four answers
代办存折|Passbook agency
代办身份证|Agent ID
代办文凭|Diploma agency
代办信用卡|Credit card charge d'affaires
代办银行卡|Agent bank card
代开发漂|On behalf of the development drift
代制身份證|Generation ID card system
发漂代开qq|Hair bleach and open QQ
发票出售|Invoices for sale
发票代开qq|Invoices and open QQ
假护照办理|Fake passport
警官证办理qq|Jing Guanzheng handle QQ
考生名单出售|List of candidates for sale
考生信息出售|Candidate information for sale
可过机假钞|Machine can be had counterfeit
卖银行卡|Sell ​​bank card
批发假币|Wholesale counterfeit money
批发假钞|Wholesale counterfeit
批发假钱|Wholesale fake money
批发假硬币|Wholesale fake coins
批发信用卡|Wholesale credit card
批发银行卡|Wholesale bank cards
税票代开qq|Unstamped and open QQ
文凭代办qq|Diploma agency QQ
银行卡出售|Bank cards for sale
真实身份证qq|Real ID qq
真钱买假钱|Real money to buy fake money
专业办证|Professional Accreditation
转让存折|Books for sale
转让发票|Transfer invoice
转让身份證|Transfer ID
转让信用卡|Transfer credit card
转让银行卡|The transfer of bank cards
诚信代开发票|Integrity and the development of votes
代开发票qq|Development of votes QQ
代开各类发票|And open all kinds of invoices
专业办证刻章|Professional Accreditation engraving
2011最新成人论坛|2011 New Adult Forum
3d性爱电影|3D sex movie
52异性社区|52 heterosexual community
aaaa级电影|AAAA-rated movies
av美女小视频|AV beautiful little video
b毛图|b gross figure
e夜情俱乐部|e-night club
gay上门服务电话|GAY-site service call
luo聊|luo chat
mb按摩服务|MB massages
qq裸舞|QQ naked dance
sm女王调教|SM Queen tune
xiaav论坛|XIAAV Forum
爱就操成人网|Love parade adult network
暗鹰国|Dark Eagle State
操烂骚|Sao rotten parade
操骚妇|Sao women parade
操骚货|Operation tart
厕所偷拍淫图|Candid toilet kinky map
插老师穴|Teacher plug hole
插穴图|Plug hole chart
超速性快感|Speeding sexual pleasure
成人爽片|Adult cool piece
成人贴图区|Adult map area
出台包夜|The introduction of night package
大学生包夜服务|Students pack the night service
肛交服务|Anal sex service
兼职美女包夜|Part-time beauty night package
交换人妻|Wife swap
口交服务|Oral sex service
丽人上门服务|Beauty-site service
美女露鲍|Beauty Lucy Martin
美女上门服务|Beauty-site service
美女上门全套|A full beauty home
男妓服务|Prostitutes Service
女奴调教|Slave girl tuning
女奴上门|Slave girl home
人兽交|Bestiality
三级激情|Three passions
骚r女自m慰|Sao r m female self-comfort
上门全套服务|On-site full service
少妇服务|Young woman Service
兽兽门视频下载|Beast beast video download
双穴插入|Double hole insert
丝袜上门|Stockings home
松岛枫下载|Kaede Matsushima download
同城换妻|City Wife Swap
小姐上门按摩|Miss home massage
性爱美图|Sex beauties
学生妹包夜|School girls night package
学生妹出台|School girl introduced
学生妹上门|School girl home
鸭子上门按摩|Ducks home massage
艷情淫穢|Erotic obscene
一本道下载|A road download
一本道无码|A road Uncensored
淫秽口交|Obscene oral sex
淫穢圖片|Pornographic pictures
淫乱地址|Promiscuous address
淫乱电影|Promiscuous movie
淫图下载|Kinky image download
秃鹰皮碗|Vulture cup
气枪价格|Airsoft price
代开保真发票|Fidelity and open invoices
娥眉皮碗|Crescent cup
45mm狗粮|45MM Dog Food
45mm铅弹出售|45MM lead bullets for sale
54式762mm枪|54 762mm gun style
54式麻狗|54 style hemp dog
54式送狗粮|54 formula feeding dog food
54手狗|54 Hand Dog
9mm枪提供|9mm gun provided
ffx氣槍銷售|FFX airgun sales
fx气皇专卖|FX gas monopoly Wong
pcp新贵出售|PCP upstart sale
q賣高壓氣槍|q sell high pressure air gun
步枪专卖|Rifle Monopoly
步槍专卖|Rifle Monopoly
出售工字气|The word gas sale
出售海豹m9|Seals sale M9
出售锡锋枪|Tin Feng gun sale
单管猎狗|Single tube hounds
电话枪子弹|Phone gun bullets
電話槍子彈|Phone gun bullets
訂購槍子彈|Order gun bullets
俄罗斯654k|Russia 654K
钢珠左轮狗|Ball revolvers dog
工字汽狗|Steam word dog
工字牌汽枪|Jeans brand QiQiang
工字皮碗|Word cup
供应手槍子彈|Supply pistol bullets
供应台湾秃鹰|Supply Taiwan Vulture
广州三箭气枪|Guangzhou three arrows airgun
虎头猎枪|Steller shotgun
虎头双管|Steller's double-barreled
虎头五连发|Steller five bursts
虎頭獵槍|Steller shotgun
火药当面交易|Gunpowder face transactions
火药看货付款|Gunpowder see the goods payment
金鐘氣槍|Admiralty airgun
进口汽狗|Imports of gasoline and dog
进口秃鹰qq|Imports of vultures qq
警服出售|Uniforms for sale
警棍出售|Baton for sale
狙击狗粮|Dog attacks
军品 枪出售|Military gun sale
雷管 当面交易|Detonator face transactions
双管猎枪 售|Double-barreled shotgun for sale
猎枪30发提供|Shotgun 30 rounds offer
猎枪出售|Shotgun for sale
猎枪专卖|Shotgun Monopoly
猎槍出售|Shotgun for sale
猎槍买卖|Shotgun sale
獵頭者出售|Headhunter sale
買賣 獵槍|Trading shotgun
卖仿真手槍|Sell ​​imitation gun
卖广州三箭气|Guangzhou three arrows sell gas
卖三箭牌气枪|Wrigley sell three airgun
美洲豹m84|Puma M84
批发步槍|Wholesale rifle
批发手槍|Wholesale pistol
批发警棍|Wholesale batons
批发警用品|Police supplies wholesale
批发炸药|Wholesale explosives
起爆药制作|Initiating drug production
气狗配件出售|Gas dog accessories for sale
气狗专卖|Dogs gas monopoly
气鸡秃鹰|Gas chicken vultures
气槍购买|Airgun purchase
汽狗出货|Dogs steam ship
汽狗电话|Steam dog phone
汽狗技术转让|Dogs steam technology transfer
汽狗支付宝专卖|Steam dog Alipay Monopoly
汽狗制造图|Steam dog shop drawings
汽枪专卖|QiQiang Monopoly
氣狗销售|Dogs gas sales
铅弹狗粮|Pellet dog food
枪诚信经营|Gun integrity management
枪免定金|Gun-free deposit
枪支直销|Direct firearms
三箭牌汽枪|Three Wrigley QiQiang
山猪气手枪|Boar air pistol
手狗出售|Hand Dog for sale
手狗买卖|Hand dog sale
手狗专卖|Hand Dog Monopoly
手铐专卖|Monopoly handcuffs
手雷当面交易|Grenade face transactions
手雷看货付款|Grenade see the goods payment
售64式枪|Sale 64 gun
售电动长狗|Sale of electric long dog
售斗角式枪|Sale bucket angle gun
售仿真枪|Sale of imitation guns
售警棍qq|QQ batons sale
售狙击枪|Sale sniper rifle
售麻醉枪|Tranquilizer gun sale
售汽狗|Steam dog sale
售三箭牌汽枪|Wrigley sold three steam gun
售手狗|Hand dog sale
售手铐qq|QQ handcuffs sale
售手拉awp|Hand AWP sale
售水胶炸药|The sale of water gel explosive
售司马系列气狗|Sima Series Air Dogs for sale
售提供军用l枪|L provide military gun sale
售赵氏弓弩|Zhao crossbow for sale
提供仿真枪模|Provide imitation guns mold
提供汽狗|Dogs provide steam
禿鷹汽槍|Vulture QiQiang
秃鹰到货|Vulture arrival
秃鹰电话|Vulture phone
秃鹰订购|Vulture Order
秃鹰技术转让|Vulture technology transfer
秃鹰汽狗|Vulture steam Dog
秃鹰汽枪|Vulture QiQiang
土炸药提炼技术|Soil explosives refining technology
瓦斯手狗|Gas Hand Dog
英国骚本pcp|British show of the PCP
预定自制 猎枪|Book homemade shotguns
炸弹 当面交易|Bomb face transactions
炸药当面交易|Explosives face transactions
炸药专卖|Dynamite monopoly
炸药制作|Making explosives
製作炸藥qq|QQ making explosives
专卖气槍|Monopoly airgun
专卖手狗|Monopoly hand dog
专卖手槍|Monopoly pistol
专卖枪械模型|Monopoly firearms model
转让炮弹|Shells for sale
转让手榴弹制作|Grenade transfer production
转让炸弹|Transfer bomb
子彈出售|Bullet for sale
子彈電話|Bullet phone
自制手狗|Hand-made dog
黄/色,电影|Yellow / color, movies
叫,床|Called bed
激,情,电影|Excited, love, movie
看,黄,电,影|Look, yellow, electric, shadow
黄,电,影|Yellow, electric, shadow
野人谷甩棍|Savage Valley rejection stick
专卖麻醉驽箭|Monopoly anesthesia dull arrow
批发精仿刀具|Wholesale fine imitation tool
弩枪专卖|Crossbow gun Monopoly
售军品军刀|Sale of military saber
.duowomn.|
duowomn|
qq：2662484067|
激情落聊|Passion off chat
香港六合彩|Hong Kong Mark Six
中国汽狗商城|China Automobile dog Mall
两性淫乱地址|Promiscuous bisexual address
喀什暴乱|Kashi riots
叶城暴乱|Yecheng riots
叶城县出事|Yecheng accident
叶城砍死汉族人|Yecheng hacked Han
喀什暴乱死人|Kashi riot dead
喀什砍死人|Kashi hacked people
喀什叶城县|Kashgar Yecheng
叶城骚乱|Yecheng riots
维族人杀人|Uighurs murder
叶城喀什|Yecheng Kashi
维族暴乱|Uighur riots
江蛤蟆|River toad
喀什暴动|Kashi riots
uyhurkurultay|
turkestan|
西尔艾力|西尔艾 force
叫春性息交流|Jiaochun of information exchange
"纪元导航"|"Era navigation"
"九评"系列社论|"Nine Commentaries," a series of editorials
"六一零"绑架|"Six hundred and ten" kidnapping
"中南海"太子党|"Zhongnanhai" princelings
【正悟网】|Wu network [is]
001-416 -361 -9895|
001-604-276-2569|
001 -800 -546 -4518|
001 -818 -338 -2883|
001 -888 -892 -8757|
001-201-625-6301|
001-510 -372 -0176|
001-626-457-8037|
001-702-248-0599|
001-866-697-6570|
1 -888 -892 -8757|
425回顾"反迫害|425 Review of "persecution
702 -873 -1734|
aboluowang"邓玉娇|aboluowang "Deng
cipfg“迫害|cipfg "persecution
cipfg记者|CIPFG Reporter
dadaogcd2009@gmail|
dajiyuan纪元|dajiyuan era
epochtaiwan"中共|epochtaiwan "CCP
epochtimes  中共|epochtimes CCP
epochtimes"九评|epochtimes "Nine Commentaries
epochtimes"中共|epochtimes "CCP
fgmtv"放光明|fgmtv "shine
gardennetworks"epochtimes|
ntdtv热点|NTDTV hotspots
ntdtv神韵|ntdtv charm
presidentoffice@chinainterimgov|
renminbao"中共|renminbao "CCP
secretchina"看中国|secretchina "Look Chinese
secretchina中共|secretchina CCP
selfip"secretchina"ncn|
tuidang"epochtimes|
tuidang@epochtimes|
tuidang@gmail|
tuidangcenter@fastmail|
tuidang九评|tuidang Nine Commentaries
阿波罗网"中共|Apollo Network "CPC
奥运前访民抓捕|Petitioners arrest before the Olympic Games
摆脱中共附体|Get rid of the CCP possessed
拨开迷雾看中共|Unfogging CPC
操纵海外特务|Manipulate overseas spy
超越红墙|Beyond Redwall
陈锦缘 王亦笑|WANG Yi Chan Kam edge laugh
陈破空"中共|Chen Po Kong "CPC
陈啸"高官轮奸|Chen Xiao, "senior gang rape
打倒共产党|Down with the Communist Party
大法弟子"迫害|Dafa disciples' persecution
大法弟子恭祝|Dafa disciples Wish
大法弟子受酷刑|Dafa disciples tortured
悼念"解体中共|Tribute to "disintegrate CCP
动态网最新地址|The latest dynamic network address
恶警"恶报案例|Guards "roost Case
恶警"国保大队|Guards "National Security Brigade
恶警"洗脑班"|Guards "brainwashing"
费良勇"中共|Fees Liangyong "CPC
封锁 突破中共|Communist blockade breakthrough
共产党"九评之|Communist "Nine Commentaries
共产党杀人历史|Communist murder history
共产邪党|Evil Communist Party
共产邪灵|Communist evil
关贵敏、戚晓春|Shut your Min, Qi Xiaochun
郭泉"贾甲|Guo Quan "Jia
郭永丰"国保|Guo Yongfeng "national security
海外声讨"江贼|Overseas denounce "Jiangzei
郝凤军"国保|Hao Fengjun "national security
红朝谎言录|Red lie towards record
记者方晓"纪元|Reporter FANG Xiao "era
记者韩瑞"报导|Reporter Hanseo "reported
纪元"记者骆亚|Era "reporter Luo Asia
纪元周刊"中共|Weekly era "CPC
纪元专栏作家|Age columnist
贾甲"儿子贾阔|Jia "son Jia wide
贾甲回国|Jia returning
江胡斗"阿波罗|Jiang Hu Doo "Apollo
江胡斗周永康|Jiang Hu Zhou Yongkang bucket
江氏独裁"中共|Jiang's dictatorship "CPC
江氏流氓集团|Jiang rogue group
揭露中共 迫害|Exposing the CCP's persecution
解体党文化|The disintegration of the party culture
九评传"保平安|Nine Commentaries on the biography "security and peace
抗暴"解体中共|Uprising "disintegration of the CCP
劳教610恶警|Detention 610 guards
李天笑"中共|Tian laugh "CPC
林轻舟"看中国|Forest Adventure "See China
刘京"高智晟|Liu Jing, "Gao Zhisheng
六一零 劳教所|Six hundred ten labor camps
六一零"刘京|Six hundred and ten, "Liu Jing
马三家"教养院|Masanjia "workhouse
灭中共 退党|Off CCP resignations
灭中共四周年|Off the fourth anniversary of the CPC
明慧网版权所有|Minghui Copyright
明慧网二零零|Minghui two hundred
迫害大"法弟子|Persecution big "Law disciple
迫害新唐人|Persecution NTDTV
迫害真相调查|Investigation on Persecution
谴责中共 迫害|Condemned the CCP's persecution
清莲"净莲|Pure Lotus "Joren
邱明伟"退党|Qiu Mingwei 'resignations
全球退党大潮|Global tide of resignations
全球逐毛日|Global-by-hair day
001 -626 -457 -8037|
认清中共本质|A clear understanding of the nature of the CCP
神韵纽约艺术团|Shen Yun Performing Arts New York
声援 退党集会|Resignations solidarity rally
声援大陆 退党|Solidarity with the mainland resign
盛雪女士"中共|Ms. Sheng Xue "CPC
唐柏桥"中共|Tang Baiqiao "CCP
退党"解体中共|Quitting the CCP "disintegrate CCP
退党"中共|Resignations "CCP
退党保平安|Resignations security and peace
万人"和平上访|People "Peace petition
万人三退"天灭|Three people back "days off
武警"大纪元|Armed "The Epoch Times
洗脑班迫害|Brainwashing persecution
邪党"中共|Evil party "Communist
邪恶中共"修炼|Communist evil "practice
新唐人"反迫害|NTDTV "persecution
新唐人"退党|NTDTV 'resignations
新唐人电视台|NTDTV
学员绑架迫害|Student kidnapped persecution
以暴力恐怖夺取|Seize terrorist violence
义工 退党服务|Volunteer resign Service
永康下台"公安|Yongkang step down "public security
遭恶报"迫害法|Roost was "persecuted law
赵子法报导|Zhao Zi law reports
真善忍美展|Forbearance Art Exhibition
真相资料"修炼|Truth data "practice
正见网"中共|Zheng Xianwang "CCP
侄女婿周永康|Nephew-in-law Zhou Yongkang
致胡温公开信|Caused by an open letter to Hu and Wen
中共"纪元时报|Communist "era Times
中共"任百鸣|CCP "Ren Baiming
中共"下达密文|CPC "issued ciphertext
中共暴政|Communist tyranny
中共的暴政|Communist tyranny
中共海外渗透|Overseas Chinese Communist infiltration
中共谎言"暴力|Communist Lies "Violence
中共流氓|Communist hooligans
中共退党潮|CCP resignations tide
中共邪党|CCP
中共邪恶专制|Communist tyranny of evil
中共邪灵|CCP evil
中共政权"伍凡|Chinese Communist regime "Wu Fan
中国共产党暴政|Chinese Communist tyranny
中国禁闻|China banned smell
中国冤民大同盟|Chinese LCV
自焚伪案|Pseudo-self-immolation case
求购迷奸药|Buy Rohypnol
求购迷晕药|Buying drugs halo fans
出售迷奸药|Rohypnol sale
出售迷晕药|Selling drug halo fans
代办 假证|Agent false
代办 假户口|Agency fake accounts
做原子弹 方法|Do bomb method
c4炸弹 制作方法|c4 bomb-making method
轻松制作原子弹|Easy to create the atomic bomb
天剑一型飞弹|Sky Sword I
共残党|Total residual party
瘟家鸨|Blast home Bustard
瘟假鸨|Blast false Bustard
无帮国 无官正|No country has no official help now
毛贼东|Thief East
毛厕洞|Gross toilet hole
毛厕东|Mao toilet East
胡紧套|Hu sleeve
邓哈狗儿|Deng Ha dogs
瘟假饱|False full blast
温假饱|Wen fake full
习猪、胡狗|Xi pigs, dogs Hu
泽民劣迹揭底|Zemin misdeeds Jiedi
立刀日尧三皮|Li Yao three leather knife Day
文刀日尧水皮|Wen Yao Water Paper Knife Day
文刂日尧氵皮|Man Pianpangriyaoshui skin
文刀日尧三皮|Wen Yao three leather knife Day
刘哓波+诺贝尔|Liu Xiao-wave + Nobel
营救刘晓波|Rescue Liu Xiaobo
声援刘晓波|Solidarity with Liu Xiaobo
崔卫平 刘晓波|Cui Weiping Liu Xiaobo
中国 零八宪章|Chinese Charter 08
警方拘捕刘晓波|Police arrested Liu Xiaobo
2008xianzhang@gmail|
零八宪章 签名|Charter 08 signature
官民对立激化|Officials and the public opposition intensified
刘霞遭软禁|Liu Xia, under house arrest
刘晓波回忆录|Liu memoirs
望当局幡然悔悟|Hope the authorities come to their senses
杜绝以言治罪|Put an end to the criminalization of speech
莫少平刘晓波|Mo Shaoping Liu Xiaobo
丁子霖 天安门|Ding Zilin Tiananmen
退党报平安|Resignations snapshots
001-888-892-8757|
退党退团|Resignations league
汉奸温贼|Wen traitor thief
瘟假宝|Blast fake treasure
瘟家报|Blast family newspaper
baidu1127|
北京政变|Beijing coup
周永康被抓|Zhou was arrested
北京军事政变|Beijing military coup
小姐上门服务|Miss home services
胡温暴政|Hu and Wen tyranny
共党邪党|Evil communist party
胡温被抓|Hu and Wen was arrested
帝都政变|Imperial coup
薄xl被软禁|XL thin house arrest
推翻中共独裁|Overthrow the Communist dictatorship
天要灭中共|Days to destroy the CCP
六合彩庄家|Makers Mark Six
薄瓜瓜|Bo Guagua
陈晓丹|Chen Xiaodan
薄家勤务|Thin home service
张晓军|Zhang Xiaojun
谷 开 来|Gu
薄 瓜 瓜|Thin melon melon
王立军爆料|Wang Lijun broke
万盛发生暴乱|Wansheng riots
薄 熙来|Bo Xilai to
薄一波儿子|Bo Yibo son
谷 开来|Gu
薄呱呱|Thin quack
还我万盛|Also I Wansheng
万盛暴乱|Wansheng riots
万盛出事|Wansheng accident
綦江和万盛|Qijiang and Wansheng
万盛和綦江|Wansheng and Qijiang
綦江警察打人|Qijiang police beating
綦江狗|Qijiang dog
薄 熙 来|Bo Xilai to
万盛暴动|Wansheng riots
万盛雄起|Wansheng resurgence
薄曦来|Xi thin to
１７１７k。tk|
螺聊|Lo chat
guo聊|GUO chat
棵聊|Trees chat
秀.b.团|Show .B. Mission
衤果聊|衤 fruit chat
锣聊|Gong chat
a片播放器|A piece player
qvod成人|qvod adult
sevbbs|
爱欲狂潮|Eros frenzy
周群中革中央|Zhou Qun Revolutionary Central
██黄片|██ porn
qq 2678451945|
大奶少妇|Big Tits young woman
性交,图片;|Sexual intercourse, picture;
性交,视频;|Sex video;
性交图片|Sex pictures
性交视频|Sex video
性教官|Of instructors
１７１７k．tk|
成入电影|Into the movie
大ｊｂ|Large JB
霪水|Heavy rain water
情色,论坛;|Erotic Forum;
真实作爱场景|Real make love scene
情色成人基地|Erotic adult base
情色贴图|Erotic map
成人,dv;|Adult, dv;
成人,电影;|Adult movies;
成人dv|Adult dv
成人{2}小说|{2} adult fiction
成人激情网站|Passion adult website
戒色论坛|Jiese Forum
淫兽学园|La Blue Girl
淫{5}秽|{5} kinky dirty
淫女;|Yinnv;
淫情女教师|Kinky love female teachers
淫荡,照片|Sensuality, photos
淫荡,美女;|Sensuality, beauty;
淫荡,视频|Sensuality, video
淫荡照片|Lewd photo
淫荡美女|Sensuality beauty
淫荡视频|Lewd video
淫魔;|Possessed;
淫魔舞会|Possessed dance
激情淫电影|Passion kinky movie
美女,写真|Beauty, photo
美女,裸体;|Beautiful, naked;
美女伴我游|I swim with beauty
肛交;|Anal sex;
色情,小说;|Erotic fiction;
色情,影片;|Porn movie;
色情,服务|Erotic services
色情,电影;|Porn, movies;
色情,表演|Pornographic performances
色情服务|Erotic Services
万人游行|Million march
学生游行|Student demonstrations
上街游行|Took to the streets
百凤宫|One hundred Feng Gong
百性阁|One hundred of the Court
暴劫倾情|Scarred Memory
暴王淫妃|Puwangyinfei
暴走烈女|Runaway paragons
北妹皇后|North sister Queen
不良少女日記|Bad girl diary
采花网|Flowers Network
滄瀾曲|Lan Cang song
藏娇寡妇|Hidden Concubine widow
操烂骚妇|Caolansaofu
草榴社区|Grass pomegranate community
成人av下载|Adult av download
成人高清电影|Adult HD movies
成人激情聊天室|Passion adult chat rooms
成人激情图片|Adult Passion Pictures
成人裸聊|Adult nude chat
成人小说下载|Adult novel download
色bb吧|BB color bar
色大嫂|Color sister
色狗成人电影|Color dog adult movies
色鬼投胎|Goat reborn
色界论坛|Color industry forum
色狼谷|Satyr Valley
色狼谷超级色站|Super color satyr Valley Station
色情草榴社区|Porn grass pomegranate community
色情四情妹|Porn four sister love
色人阁成人影院|People of color Adult Theater Club
色色淫情网|Color color kinky love
色上色导航|Color color navigation
色淫嬉女媳站|Color Yinxinvxi station
色域色吧|Gamut color bar
色欲檔案|Sex Archives
色欲追魂|Sex and Deception
q1506664048|
ｑ38453853８|
广州游行|Guangzhou parade
散发遗书|Sporadic suicide note
永巩二横巷|Yong Gong two lanes
拆迁钉子户|Nail house demolition
拼死护房|Desperate nursing room
攻击菲律宾|Attack of the Philippines
围攻大使馆|Embassy siege
使馆门口抗议|Embassy protest door
焚烧国旗|Flag burning
上街示威|Took to the streets
党代会上访|Congress petition
市府门口静坐|Sit-door Civic
政府门口集合|Government door collection
冲进派出所|Stormed the police station
自杀喊冤|Suicide innocence
集体去中央|Central to collectively
北京上访|Beijing to petition
市府上访|Civic petition
冲向会场|Rushed to the venue
跳楼讨薪|Jumping pay talks
去幼儿园砍人|Go to kindergarten knives to injure
丝袜诱惑点击看|Click to see the temptation stockings
ｆｓｑｂｂ．ｃｏｍ|
1uo聊|1uo chat
millionaire relations|
jinping millionaire|
bloomberg jinping|
china blocks bloomberg|
xi jinping story|
china censors bloomberg|
who turns 59 this month|
bloomberg for political report|
彭博通讯社|Bloomberg
张燕南|Zhang Yannan
习明泽|Xi Mingze
xi mingze|
习远平|Xi Yuanping
xi yuanping|
习大傻|Xi Dasha
彭博 近平|Bloomberg nearly flat
彭博 屏蔽|Bloomberg shield
relations revea|
fortunes of elite|
彭博在中國|Bloomberg in China
邓家贵|Dengjia Gui
中共国务院|CCP State Council
falu功|FALU power
falu大法|FALU Dafa
京温跳楼事件|Jing Wen jumping events
袁利亚离奇死亡|Yuan Leah died mysteriously
承接球赛|Undertake Match
逃往云南红河|Fled to Yunnan Honghe
暴徒有两个来了|There are two thugs come
抓了两个新疆人|Arrested two people in Xinjiang
曾在广州被处理|Had to be treated in Guangzhou
逃往贵阳方向|Guiyang fled direction
中国开始乱了！|China began to mess up!
在红河做的计划|Plan to do in the Red River
看到新疆人就打|See people hit Xinjiang
维族狗|Uygur dog
2000东突入大陆|2000 East broke into mainland
五人被坦克压死|Five people were killed tanks
现场大秀|Scene big show
大秀现场|Big show scene
主播妹子好骚|Good show anchor sister
直接看成人站|Look directly adult station
看脱衣来|Look undressing to
夫妻秀|Couples show
爆破工程师挂靠|Blasting engineers affiliated
爆破证挂靠|Blasting certificate anchored
爆破挂靠|Blasting anchored
1989年6月4日|June 4, 1989
茉滤花|Jasmine flower filter
刘士辉|Liu Shihui
翻墙方法|Method over the wall
天安门广场|Tiananmen Square
我们要吃饭|We want to eat
我们要工作|We want to work
我们要住房|We want housing
我们要公平|We must be fair
我们要公义|We Yaogong justice
开放报禁|Press restrictions
校内聚会点|School meeting point
10处教会集会点|10 church meeting point
20处高校集会|20 colleges rally
下周咱接着耗|Then next week we consume
你撤岗我聚集|I gather you withdraw Gang
政府门前|In front of the government
北京外交部|Beijing Department of State
南海行为准则|South China Sea code of conduct
我以我血荐轩辕|I am in my Blade Heart
占领华尔街|Occupy Wall Street
occupy together|
清扫华尔街|Sweeping Wall Street
全球大串联|Global series
占领北京|Occupied Beijing
阿拉伯之春|Arab Spring
埃及革命|Egyptian revolution
要民主不要金主|Do not want democracy gold master
一起占领|Occupation together
良知的守望者|Catcher conscience
中国驻韩大使馆|Chinese embassy in Seoul
韩国示威|South Korean protesters
抵制中国货|Boycott Chinese goods
烧使馆|Burn embassy
韩国使馆|South Korean Embassy
海量罢工|Massive strike
声援海量|Massive solidarity
爱国救党|Patriotic rescue party
公安部部长辞职|Public Security Minister resigns
胡海峰贪污|Hu Haifeng corruption
胡海峰的告诫|Mr Hu's warning
胡皇帝|Hu emperor
胡金涛|Hu Jintao
胡紧涛|Hu Tao tight
胡尽掏|Hu do dig
胡尽桃|Hu make peach
胡劲涛|Hu Jintao
胡劲掏|Hu Jin dig
江复活|Jiang resurrection
江辛亥|Jiang Xinhai
江诈尸|Jiang corpses
江core|Jiang CORE
江zms了|Jiang zms the
江病危消息|Jiang dying message
江的遗体告别|Jiang's funeral
泽民的远亲|Zemin distantly
江泽民病逝|Jiang died
锦涛堂弟胡锦星|Hu Jintao cousin Star
曲解重庆实践|Chongqing practice misinterpreted
锦涛下台|Jintao step down
从逆向思维出发|Starting from the reverse thinking
全方位不满|Round dissatisfied
熙来另起炉灶|Hee to start all over again
绝妙棋子赖昌星|Wonderful piece Lai
靠唱红打黑扬名|By famous anti fame
赖昌星秘密审讯|Lai secret trial
孟不长|Bangladesh is not long
孟见住|Meng see live
微博挑战胡|Hu microblogging challenge
当局哭笑不得|Authorities dumbfounding
温jb|Wen jb
温公阁下|WEN Gong Excellency
温加宝|Wen Jia-bao
温家室|Winchester Room
温假宝|Bao Wen false
温情一把戏子泪|The warmth of a child tears trick
瘟加宝|Blast plus treasure
瘟加暴|Plus storm blast
瘟家包|Blast home package
瘟家饱|House full blast
闻家暴|Wen domestic violence
子珍侄子|Jane nephew son
德生之子|Son of Germany
总理大位|Prime big bits
不判你死刑|Not sentence you to death
最后的棋局|The last game of chess
人民报消息|De Volkskrant news
人民报每日版|De Volkskrant daily edition
大陆七位学人|Seven mainland scholars
刘霞诗选|Liu Xia Poems
审美与人的自由|Aesthetics and Human Freedom
形而上学的迷雾|The Fog of Metaphysics
零八 宪章|Charter 08
刘晓波简介|Liu Xiaobo Introduction
"中共"邪党|"Communist" evil party
610办公室|610 Office
"零八宣言"|"And eight of the Declaration."
独立中文笔会|Independent Chinese PEN
民族主义批判|Nationalist critique
选择的批判|Select criticism
lxb 挪威|LXB Norway
刘晓波 刘霞|Liu Xia
刘和谐晓波|Liu Xiaobo harmony
刘0晓0波|Liu Xiao 0 0 wave
刘大波的弟弟|Liu Dabo's brother
刘晓庆的咪咪|Mimi Liu
六四屠杀|4 June massacre
八九民主运动|Eighty-nine democratic movement
天安门屠杀|Tiananmen massacre
ⅷⅸ事件|ⅧⅨ event
天安门清场|Tiananmen clearance
四二二事件|Four hundred twenty-two event
坦克辗压|Tanks rolling
难忘的8天8夜|Memorable eight days and eight nights
四二一游行|Four hundred twenty-one parade
烛火悼念|Candlelight Tribute
23年祭|23 years offering
香港维园|Hong Kong's Victoria Park
六四遊行|Sixty-four parade
5月35日|May 35 May
黑文化衫|Black T-shirt
陆雪琴|Lu Xueqin
袁绍华|Yuan Shaohua
“酷刑”清单|"Torture" list
酷刑清单|Listing torture
酷刑迫害|Persecution torture
邓*小平|Deng Xiaoping *
法论功|Falun Gong
暗茉莉|Dark Jasmine
瘟嘉宝|Garbo plague
伏紧套|V sleeve
富紧逃|Rich fled tight
刘贤斌|Liu Xianbin
邓二江三|邓二江 three
国母祖英|Mother of the country Zuying
狐紧套|Fox sleeve
狐劲套|Fox Jin sets
呼尽套|Call to make sets
洗尽贫|Washed away the poor
喜禁瓶|Hi bottle ban
九评中共|Nine Commentaries on the Communist Party
大法弟子|Dafa disciples
中共帮凶|CCP accomplices
共产邪|Communist evil
退党热线|Resignations Hotline
九评共|Nine Commentaries on the total
中共解体|Communist disintegration
灭中共|Off the CCP
中共邪教|Communist cult
退出中共|Quit the CCP
共党暴政|Communist tyranny
中共独裁|Communist dictatorship
中央团派|Central tuanpai
中共团派|Communist Youth League
中国毛派|Maoist China
韶山之光|Shaoshan Light
中革中央|Revolutionary Central
民主斗士|Fighter for democracy
天下围城|Siege world
全民倒共|Total national pour
89闹学潮|89 student strike
邓小平屠杀|Deng Xiaoping massacre
天安门屠城|Tiananmen massacre
liusixueyun|
8平方那事|8 square that thing
64图片|64 Photos
6si事件|6si event
thetankmen|
64政变|64 coup
64屠城|64 massacre
64之前|Before 64
64前后|64 before and after
onenineeightnine|
64敏感|64 sensitive
89风云|FY 89
3小时纪录片|3 hours documentary
27军军长怒砸|Army commander angrily smashing 27
柳丝25周年|Stir 25th anniversary
六④25年祭|Six years of sacrifice ④25
某事件25周年|25th anniversary of an event
25年前柳丝|25 years ago Stir
25周年8x8|25th Anniversary 8x8
25年八平方|25 years eight square
22year64|
25年xue朝|25 years towards xue
22陆肆|22 Lusi
tam事件25周年|TAM 25th anniversary event
x事件25周年|x 25 anniversary events
88事件25周年|88 25th Anniversary Event
22yearsago|
junefour25周年|junefour25 anniversary
6四22year|6 four 22year
liusi22year|
陆肆25周年|25th anniversary of the Lusi
tiananmen事件25周年|tiananmen 25th anniversary event
哀悼民运|Mourning pro
2x32事件|2x32 event
六四后札记|After June Fourth Notes
赵zi阳|Yang Zhao zi
方li之|The party li
吾er开西|I er open West
吾er开xi|I open XI ER
天安门运动|Tiananmen movement
刘小波能得奖吗|Liu Xiaobo winning can do
tian安men|tian security men
天xx事件|XX day event
t安门事件|T Tiananmen incident
流si|Flow si
广场禁白衣|Square white ban
六四亡魂|Sixty-four Revenant
25年前|25 years ago
民主人士被软禁|Democrats are under house arrest
解放报禁|Liberation ban
当局的理念|Authorities philosophy
五月三十五日|Thirty May 5
五月三十五号|May 30 V
鹿死瓶反|Anti dead deer bottle
25周年|25th Anniversary
张先玲|Zhang Xianling
绝食24小时|24 hours hunger strike
民主书院|Democracy College
零星自发悼念|Sporadic spontaneous memorial
六四黑手|Sixty-four Blackhand
二十二周年|22 Years Anniversary
华叔短片|Uncle Wah Movie
勿忘今日|Do not forget today
中共违反人权|CCP human rights violations
六四聚会|Sixty-four party
25周年庆|25th anniversary
25周年纪念|25th Anniversary
瓶翻鹿死|Bottle turned dead deer
瓶fan鹿死|Bottles fan dead deer
误尔开希|Seoul mistake Kaixi
五而开西|The opening five West
捂而开西|Cover and open the West
吴耳开息|Wuerkaixi
我儿开西|My children open the West
52凯xi|52 Kay xi
沃儿凯西|Kathy Waugh children
吴耳凯西|Wu ear Casey
吴耳开西|Miss West ears open
乌尔楷西|Ur Kai West
沃儿开西|Wal children open West
此木王令|This wood Wang Ling
此木玲|This wood-ling
五二开西|Fifty-two Open West
五二开席|Fifty-two open seats
把九的事|The nine things
52开c|52 open c
六月寺号|June Temple No.
吴而开西|Wu and open the West
舞而开西|Dance and open the West
无二凯西|Casey goes
six月四号|six months fourth
89xue潮|89xue tide
89学巢|89 school nest
64事见|64 things to see
鹿4|Deer 4
25年前6月|25 years ago in June
北.京之春|North. Beijing Spring
北京大屠杀|Beijing massacre
北京屠杀|Beijing massacre
维园纪念|Victoria Park Memorial
june4th事件|June4th event
4thofjune|
流四事件|Stream four events
异jian人士|Jian different people
天鞍们广场|Saddle day they Square
liusi死难者|liusi victims
viiiv死难者|VIIIV victims
又到64|Went to 64
1989年的运动|1989 sports
64英雄|64 Heroes
64英烈|64 martyrs
拉发事件|Rafah event
八九拉发|Eighty-nine Rafah
学潮初起|Since the beginning of the student movement
纪念拉发|Memorial Rafah
拉发晚会|Rafah party
拉发烛光悼念|Rafah candlelight vigil
六四的死难者|June Fourth victims
摧毁独裁政权|Destroying dictatorships
去广场上站一会|Square Station on the go for a while
广场的日与夜|Day and Night Plaza
学生精华游|Student Highlights Tour
六四二十二周年|Tiananmen 22 Years Anniversary
六四艺术纪念馆|Sixty-four Art Museum
六四传薪火|Sixty-four pass Passing
自由花手语舞|Freedom took sign language dance
我要回家运动|I want to go home sports
六四论坛|Sixty-four Forum
六四烛光悼念|Sixty-four candlelight vigil
六四纪念馆|June 4th Museum
6泗大学生|6 Si Students
6泗事件|6 Si event
门安天|On day door
八的平方那事|Eight of those square things
90年前一年|90 year ago
90年的前一年|90 years of the previous year
挡坦克的|Block tanks
1989xx的纪录片|1989xx documentary
64添安门|64 Tim Yasukado
青年拦坦克|Young stopped tanks
19881年6月31号|19881 on June 31
拦坦克的|Elam tanks
邓屠夫|Deng Butcher
食绝场广门安天|Fresh absolutely safe door wide field day
89年的那次|89 years that
89年那次|That 89 years
8964发生的事|8964 things happen
中国政治的禁片|Chinese politics ban films
八九天安门运动|Eighty-nine Tiananmen movement
20年前的这个时候|This time 20 years ago
tam爆乱|tam explosive disorder
89北京风波|89 Beijing storm
一九八九年六四|4 June 1989
8的平方|8 square
八9学潮|Eight nine student movement
天安门残摩|Tiananmen residual friction
天安门录影带|Tiananmen video
天安门一代|Tiananmen generation
丁子霖的名单|Ding Zilin list
民运纪念|MDC Memorial
诉江案令人鼓舞|Encouraging lawsuit against Jiang
掩盖中共镇压|Hide Communist repression
中共党魁版|Communist leader Edition
赵紫阳反思|Zhao reflection
64年屠城|64 years massacre
看中共与良心|Chinese Communist Party and Conscience
江被软禁|Jiang was placed under house arrest
赵紫阳软禁|Zhao's house arrest
木樨地枪声|Sweetclover gunfire
一九八九风波|One thousand nine hundred eighty-nine storm
一九八九事件|One thousand nine hundred eighty-nine event
天安门镇压|Tiananmen crackdown
解放军清场|PLA clearance
激流中国纪录片|Dynamic China Documentary
tiananmen学生定性|Qualitative student tiananmen
tiananmen母亲|tiananmen mother
tiananmen屠杀|tiananmen massacre
天安门访民|Tiananmen Petitioners
天安门民运|Tiananmen Square pro-democracy movement
天安门三君子|Tiananmen three gentlemen
天安门撒传单|Tiananmen leaflets
天安门情人|Tiananmen lover
天安门坦克|Tiananmen Tank
天安们事件|Tiananmen incident
天安们母亲|Tiananmen mothers
丁子霖母亲|Ding Zilin mother
大陆国家党|Continental National Party
天按门1989|Day by the door 1989
天a门事件|Days of a scandal
89六四|June 4, 1989
赵z阳集团|Zhao Z Yang Group
爱国民主大游行|Patriotic and democratic Parade
丁子霖名单|Ding Zilin list
柳丝真相|Stir the truth
屠城责任|Responsibility for the massacre
六四公投|Sixty-four referendum
八八相乘运动|Eighty-eight multiplied sports
五三五事件|Five hundred thirty-five event
六四戴晴|Sixty-four DAI
64薪火|64 Passing
64烛光|64 Candlelight
六四杀戮|Sixty-four killings
八9运动|Eight nine sports
liusi屠杀|liusi massacre
liu四屠杀|liu four massacre
六si屠杀|Six si massacre
陆肆屠杀|Lusi massacre
陆四屠杀|Lu four massacre
六肆屠杀|Six wantonly slaughter
liu肆屠杀|liu wantonly slaughter
陆si屠杀|Lu si massacre
8jiu学潮|8jiu student protests
ba9学潮|ba9 student protests
8jiuxuechao|
8jiuxue潮|8jiuxue tide
8jiu学chao|8jiu school chao
ba九学潮|ba nine student movement
bajiuxuechao|
ba九学chao|ba nine school chao
ba九xue潮|ba nine xue tide
bajiufengbo|
bajiu风波|bajiu storm
liusi风波|liusi storm
陆si风波|Lu si storm
liu肆风波|liu store storm
陆肆风bo|Lusi wind bo
陆肆feng波|Lusi feng wave
liu肆fengbo|liu store fengbo
liusifeng波|liusifeng wave
bajiushijian|
89shijian|
八九shi件|Eighty-nine shi pieces
八九事jian|Eighty-nine thing jian
8jiushijian|
89事jian|89 things jian
8九shi件|8 pieces of nine shi
8九事件|8 nine events
八9事件|Eight 9 events
8九风波|8 nine storm
八久风波|Eight long storm
捌玖风波|Jiu Ba storm
捌jiu风波|Ba jiu storm
ba玖风波|Nine ba storm
ba久风波|ba long storm
ba久fengbo|ba long fengbo
捌九风波|Ba nine storm
捌久风波|Ba long storm
八jiu风波|Eight jiu storm
ba玖fengbo|Nine fengbo ba
tiananmen风波|tiananmen storm
tian安门风波|tian Tiananmen crisis
天安men风波|Tian men storm
天安门风bo|Tiananmen wind bo
89fengbo|
8jiufengbo|
ba9风波|ba9 storm
8jiu风波|8jiu storm
8玖风波|8 Nine storm
捌9风波|Ba 9 storm
8久风波|8 long storm
8酒风波|8 wine storm
ba酒风波|ba wine storm
ba酒fengbo|ba wine fengbo
tian安门屠杀|tian Tiananmen Square massacre
天安men屠杀|Tian men massacre
陆si惨案|Lu si massacre
liu肆惨案|liu wantonly massacre
六四canan|Sixty-four canan
liusi惨案|liusi massacre
捌玖惨案|Jiu Ba massacre
捌久惨案|Ba long massacre
捌九惨案|Ba nine tragedy
八久惨案|Eight long massacre
八酒惨案|Eight liquor tragedy
八玖惨案|Eight Nine massacre
捌酒惨案|Ba liquor tragedy
6四惨案|6 four tragedy
六4惨案|Six 4 massacre
六si惨案|Six si massacre
liu四惨案|liu four tragedy
6si惨案|6si massacre
liu4惨案|liu4 massacre
64canan|
六4canan|Six 4canan
6sicanan|
天安men惨案|Tian men massacre
天安门血案|Tiananmen massacre
tiananmen血案|tiananmen massacre
天安men血案|Tian men massacre
1989fengbo|
tiananmen自焚|tiananmen self-immolation
八九年学生运动|2089 student movement
捌玖年学生运动|Jiu Ba student movement
tiananmenfengbo|
捌玖学运|Jiu Ba student movement
bajiu学运|bajiu student movement
bajiu年学生运动|bajiu year student movement
liusi枪杀|liusi shot
陆肆枪杀|Lusi shot
liu肆枪杀|liu wantonly shot
陆si枪杀|Lu si shot
八九枪杀|Eighty-nine shot
捌玖枪杀|Jiu Ba shot
八久枪杀|Eight long shot
八酒枪杀|Eight wine shot
八玖枪杀|Nine killed eight
捌九枪杀|Ba nine shot
捌久枪杀|Ba a long shot
捌酒枪杀|Ba wine shot
bajiu枪杀|bajiu shot
liusi屠城|liusi massacre
平反六四事件|Vindication event
平反陆肆事件|Lusi events vindicated
坦克事件|Tank Event
tu杀学生|tu kill students
屠sha学生|Tu sha students
捌玖动乱|Jiu Ba unrest
八酒动乱|Eight wine unrest
八久动乱|Eight long unrest
捌九动乱|Ba nine unrest
捌久动乱|Ba long unrest
捌酒动乱|Ba wine unrest
bajiu动乱|bajiu unrest
八玖动乱|Nine eight unrest
长安街的贝塔|Chang'an Avenue beta
21周年六四|21 anniversary sixty-four
21周年6月4日|21 Anniversary of June 4
二十周年风波|The twentieth anniversary of the storm
64烛光晚会|64 candlelight vigil
为六四正名|June 4 to name
六四遭坦克车压|Sixty-four was pressure tanks
89年的大学生游行|Students march 1989
大爆政局内幕|Revealing political insider
426社论发表二十年|426 editorial published two years
89为什么被屏蔽|89 Why is shielded
25年前的乱局|25 years ago, chaos
25年前天安门|Tiananmen Square 25 years ago
25年前6月4日|25 years ago, June 4
6四25周年|6 four 25th anniversary
25周年大游行|25th Anniversary Parade
64事件25周年|64 25th Anniversary Event
6425周年|6425 anniversary
25年萧瀚|25 years Xiaohan
25年学生潮|25 years student influx
25年学潮|25 years of student protests
25年广场事件|Square incident 25 years
25年六四|25 June 4
25年春夏之交|25 years of spring and summer
25周年张万舒|Zhang Wan Shu 25th anniversary
25周年89年事件|25th anniversary of the 1989 events
25周年游行|25th anniversary parade
25周年6月4日|25th anniversary of the June 4
25周年六四|25th Anniversary sixty-four
六四25周年|Sixty-four 25th anniversary
坦克进城25年|Tanks into the city for 25 years
25周年网络大会|25th anniversary of the Network Conference
6425周年游行|6425 anniversary parade
25年前的6月4号|June 4 25 years ago
25年薪火|25 salary fire
25年前广场的真相|Square 25 years ago the truth
民运25周年|25th anniversary of the pro-democracy movement
25年钱的政治风波|25 years of political turmoil money
8964大屠杀25周年|25th anniversary of the 8964 massacre
门屠杀25周年|25th anniversary of the massacre door
是非恩仇二十年|Two years of non-hatred
胡耀邦下台前后|Hu Yaobang before stepping down
政坛秘闻录|Confidential political record
是非恩仇20年|20-year non-hatred
开坦克血腥镇压|Open tanks bloody crackdown
1989nian6yue4ri|
420事件|420 events
自由中国论坛|Free China Forum
b1oodisonthesquare|
力捧下台|Touted step down
李鵬下台|Li Peng to step down
清洗天安门|Cleaning Tiananmen
反对cpc|Opposition CPC
democraci运动|democraci sports
19eighty-nine|
三小时纪录片|Three hours documentary
天安门卡玛|Tiananmen Karma
卡玛天安门|Kama Tiananmen
禁片下载|Ban movie download
禁片资源|Ban chip resources
禁片的下载|Forbidden films downloads
禁片的资源|Resources forbidden films
天安门纪录片|Tiananmen documentaries
89为什么被禁|89 Why is banned
89为什么被屏|89 Why is the screen
民运1989|MDC 1989
1989北京死|1989 Beijing dead
1989年6月的事|June 1989 things
q261178774|
party不民主|PARTY undemocratic
party封锁|PARTY blockade
天安门静坐|Tiananmen Square sit-in
426社论|426 editorial
广场上de热血|Blood on the Plaza de
宫馋党|Palace greedy party
广场上绝食|Hunger strike on the square
广场上静坐|Square sit-in on
广场洒热血|Square shed blood
广场鲜血|Square blood
1989中美交恶|1989 Sino-US hostility
gcd垮台|GCD collapse
gcd下台|GCD step down
gcd腐败|GCD corruption
tank和枪炮|tank and guns
天安门前的血案|Tiananmen massacre
拦土旦克|Lantudanke
坦克开进北京|Tanks rolled into Beijing
64天安门|64 Tiananmen
89动1乱|89 move a mess
1989年6月北京|June 1989 Beijing
gcd统治|GCD rule
一人站一坦克前|A man got a tank ago
捌玖年中国|Jiu Ba, China
学生民主运动|Student democracy movement
八jiu雪嘲|Eight jiu snow ridicule
ba九雪嘲|BA nine snow ridicule
64内幕|64 Insider
大学生动乱事件|Students unrest
64动摇了党|64 shake the party
学生静坐于广场|Student sit-in square
6月北京动荡|June Beijing unrest
六死事件|Six dead Event
gcd越来越腐败|GCD growing corruption
1989美中交恶|1989-US hostility
890604|
gcd倒台|GCD downfall
淫三国|Three kinky
sm影片|sm movie
sixfour屠杀|sixfour massacre
sixfour以后的中国|sixfour after China
sixfour的影响深远|The far-reaching influence sixfour
sixfour二十年历史事件|sixfour two decades of historical events
为六四开枪辩护|Defense shot June 4
血洗北京|Bloodbath Beijing
江泽民入承大宝|Jiang Cheng Tai Po into
六四北京学运|Sixty-four student movement in Beijing
六四北京开枪|Sixty-four Beijing shot
八九六四民运|Eight thousand nine hundred sixty-four pro
八九六四学运|Eight thousand nine hundred sixty-four student movement
八九六四学生|Eight thousand nine hundred sixty-four students
卢跃刚公开信|Lu Yuegang open letter
tiananmencrackdown|
泪水在中国流淌|Tears flowed in China
鲜血染红了广场|Blood red square
民主了爆你菊花|Democracy burst you daisy
五毛共匪吊长街|Fifty Cent bandits hanging Strip
民主了杀你全家|Democracy kill you and your family
六四悲剧|Sixty-four tragedy
六四后遗症|Sixty-four sequelae
二六社论|26 editorial
六丝动乱|Six wire unrest
把酒流斯|Wine stream Adams
学潮的兴起|The rise of the student movement of
1989春天学潮|Spring 1989 student protests
北京风波大事记|Beijing storm Memorabilia
动荡的56天|56 days turbulence
八九年的反学朝|2089 anti-science towards
89年大学生暴乱|Students riot 89 years
中丆国政府|丆 national government
天亣安门事件|Tiananmen Square incident, assume day
六丶四学生爱国|Six Dian four students patriotic
学hexie潮|Learn hexie tide
甜安门事件|Sweet Tiananmen incident
1989年的六肆|1989 Six store
19eightnine年|19eightnine years
89年6月④日|④ Day on June 89
sixfour惨案|sixfour massacre
sixfour运动|sixfour sports
六罒运动|Six 罒 sports
sixfour云东|sixfour East Cloud
sixfour风波|sixfour storm
89学氵朝|89 Rui toward school
88年雪潮|88 snow tide
89中国学生的大事|89 Chinese student affairs
死于八乘八日|Died eight by 28
腐败的铲共党|Shovel communist corruption
茉莉花运动|Jasmine Movement
kongyizi|
炎黄春秋|Yanhuang Chunqiu
空凳的主人|Empty stool owner
无人坐的凳|No sitting stool
我的最后陈述|My final statement
大国沉沦|Big country sink
稀世之音|The rare sound
黑窑童奴案|Black kiln child slavery case
大地黯淡无语|Dim silent earth
瘦瘦削削的天|Thin thin cut of the day
细细长长的木|Long thin wood
暗红色的证书|Dark red certificate
缺席的方式|Absent way
遥远的寓言|Distant fable
孔子滑稽奖|Funny Confucius Prize
搜狗南京代理商|Sogou Nanjing Agents
团车网|Mission car network
胡承认变质|Hu acknowledged metamorphism
八九学运领袖|Leader of the student movement
李锐鲍彤六四|Li Rui Bao sixty-four
凌沧洲六四|Ling Cangzhou sixty-four
六四惨案鲍彤|Sixty-four massacre Bao Tong
陆肆事件天安门|Lusi Tiananmen incident
李月月鸟六四|Lee Bird sixty-four month
1989记忆的呼唤六四|1989 Memory Call sixty-four
20周年纪念白皮书|20th anniversary of the White Paper
把酒柳丝二十年|Stir the wine two years
把酒柳丝事件|Stir wine event
陈小雅六四研究|Xiaoya Chen sixty-four research
夫人华仲尉|Mrs. Hua Zhongwei
回家运动王丹|Home sports Wang Dan
勿忘陆肆|Do not forget Lusi
学者陈小雅六四|Scholars Xiaoya Chen sixty-four
彦永致函|Yan Yong wrote
于浩成六四事件|Yu Hao into the June incident
昝爱宗六四|Zan sixty-four
赵国君六四|Zhao Guojun sixty-four
中共血腥学生|CCP bloody student
子霖蒋培坤六四|Sub-Lin Jiang Peikun sixty-four
xianzhang2008xianzhang@inbox|
丁子霖天安门|Ding Zilin Tiananmen
蒋彦永关于为|Jiang Yanyong on for
丁子霖张先玲|Ding Zilin Zhang Xianling
鲍彤先生六四|Mr. Bao Tong Tiananmen
天安门文件六四|Tiananmen Papers sixty-four
要回家运动王丹|Wang Dan to go home campaign
8964反邓反腐败惨案|8964 Anti-Corruption Anti Deng massacre
喋血之八九|Bounty of eighty-nine
ailijianyilihamu|
六四军人张世军|Sixty-four soldier Zhang Shijun
天安門學潮|Tiananmen student protests
64天安門|64 Tiananmen
女神起锚|Goddess anchor
六四的烛光晚会|June Fourth candlelight vigil
维园六四晚会|Victoria Park sixty-four party
李鹏六四日记|The Critical Moment
六四杀戮事件|Sixty-four killings
天安门示威活动|Tiananmen protests
李鹏关键时刻|Li critical moment
六四日記手稿|Sixty-four manuscript diary
李鵬六四日記|The Critical Moment
悼念六四港人|June 4th memorial Hong Kong
64小时的绝食|64 hours of hunger strike
89年xue潮|89 years xue tide
89年北京制止动乱|89 Beijing to stop unrest
六和谐四事件|Six harmonious four events
打倒和谐共产党|Down with the Communist Party of harmony
89年西藏发生骚乱|1989 Tibet riots
记念六四烈士|Martyrs Memorial sixty-four
444444事件|444444 Event
不准提及六四|Not allowed to mention sixty-four
新民主女神像|New Goddess of Democracy
徐勤先抗命事件|Xu Qinxian disobedience event
大陆媒体被禁声|Mainland media hushed
世六说实话拾|Honestly pick six World
实话实说六四|Straight Talk sixty-four
六四儿童漫画|Children's cartoon sixty-four
64tian安门|64tian Yasukado
天an门风波|AN day storm door
64二十一周年|64 twenty-one anniversary
梁国雄|Leung Kwok-hung
六四薪火|Passing sixty-four
六四希拉蕊|Hilary sixty-four
祭拜木樨地|Worship alba
6four|
2的8次方|8 th 2
二的8次方|Two 8 th
12500386|
4-jun|
捌9年的6四|Eight nine six four-year
6四屠杀|6 four massacre
6四英魂|6 four souls
天安门压大学生|Tiananmen pressure Students
21周年89年事件|21-year anniversary of the 89 events
21year64|
21年八平方|21 years eight square
21周年8x8|8x8 21 anniversary
21周年张万舒|21 Anniversary Zhang Wan Shu
21年春夏之交|21 years of spring and summer
21年六四|21 June 4
21年广场事件|Square incident 21 years
21年学潮|21 years of student protests
21年学生潮|21 years student influx
21年萧瀚|21 years Xiaohan
21年前柳丝|21 years ago Stir
64事件21周年|21 64 anniversary events
某事件21周年|21 anniversary of an event
21周年大游行|21 Anniversary Parade
6四21周年|Six four 21 anniversary
柳丝21周年|Stir 21 anniversary
21年前6月4日|21 years ago, June 4
tanktiananmen|
89tiananmen|
64tiananmen|
tiananmen六四|tiananmen sixty-four
tiananmen八九|tiananmen eighty-nine
tiananmenuprising|
massacretiananmen|
改革的历程港版|Hong Kong version of the reform course
pdf改革的历程|pdf reform course
pdf改革历程|pdf reform process
改革历程迅雷|Thunder reform process
电驴改革历程|EDonkey reform process
改革历程中文版|Chinese version of the reform process
贰拾陆肆|Hundred and sixty thousand Lusi
二十陆肆|Twenty Lusi
20陆肆|20 Lusi
六肆事件|Six store events
陆四运动|Lu four sports
陆四真相|Lu four truth
风波陆四|Lu four storm
6点40罗京|6:40 Luo Jing
支联会烛光晚会|Alliance candlelight vigil
维园烛光晚会|Victoria Park candlelight vigil
韩光长城外|Han Guang outside the Great Wall
纪念89天安门|Tiananmen Square to commemorate 89
纪念六4死难者|To commemorate the victims of six 4
六4誓愿|Six four vows
爸舅年|Dad uncle year
5月35|May 35
10*2年前|10 * 2 years ago
二0年前|20 years ago
支持六四|Support sixty-four
六四光荣的抗争|Sixty-four glorious struggle
六四自由花|Sixty-four spend freely
六四杨建利|Yang Jianli sixty-four
20周年司徒华|20th anniversary SZETO
1989protest|
1989democracy|
十问共产党|Ten Questions Communist Party
60小时绝食静坐|60 hours hunger strike sit-in
64学生事件视频|64 students in the event video
毋忘赵紫阳|Not to forget Zhao Ziyang
中青网现公开信|Youth Net is now open letter
王笃若|If Wang Du
王笃若rfa|Wang Du if RFA
邓小平8964|Deng Xiaoping 8964
韩东方领袖|HAN leaders
韩东方学运|HAN student movement
20周年韩东方|20th anniversary of the HAN
20周年6月4日|20th anniversary of the June 4
19894june|
六四学声运洞|Sixty-four Xueshengyundong
六四学生请愿|Sixty-four student petition
六四学子的鲜血|Sixty-four students of blood
1989liusi|
liusi学生运动|liusi student movement
陆肆洞乱|Lusi cave chaos
64天安门事变|64 Tiananmen Incident
198964学潮|198,964 student protests
天安门挡坦克|Tiananmen block tanks
陆月泗日|Luyuesiri
北京植物人马建|Beijing to build the plant troops
cnn重睹照片|cnn heavy see photos
六四网上游行|Sixty-four online Parade
21周年网络大会|21 Annual Network Conference
坦克进城21年|Tanks city 21 years
tianandoor事件|tianandoor event
tam事件21周年|TAM 21 anniversary events
二十一周年封网|Twenty-one anniversary censorship
大中华局域网|Greater China LAN
黄雀行动日记|Operation Yellowbird diary
血染天安门|Bloody Tiananmen
木樨地38小时|Alba 38 hours
38小时人民日报|38 hours Daily
64二十一年祭|64 twenty-one offering
民运讽刺诗|MDC satire
血路1989|Trail 1989
89北京戒严|89 Beijing martial law
改革历程港版|Hong Kong version of the reform process
陆肆运动|Lusi sports
八八相乘事件|Eighty-eight multiplied event
回顾六肆|Recalling the six store
烛光照维园|According to Victoria Park candlelight
维圆烛光|Dimensional circle candlelight
八九关键词|Eighty-nine Keywords
天安门外六部口|Tiananmen Square outside the six ports
平反柳丝|Stir vindicated
平反陆肆|Vindication Lusi
平反六four|Vindication of six four
平反six4|Vindication six4
中共天安门清场|CCP cleared Tiananmen Square
中共清场日记|CCP cleared diary
六四薪火相传|Sixty-four Passing the torch
吾尔开希入境|Wuerkaixi entry
中国黑暗事件|Chinese dark events
64维多利亚|64 Victoria
六四请愿|Sixty-four petition
中南海大上访|Zhongnanhai large petition
网路人权宣言|Internet Bill of Rights
赵zi阳回忆录|Yang Zhao zi memoirs
王炳章民运手册|Wang Bingzhang pro manual
6421周年游行|6421 anniversary parade
后六四文化祭|After sixty-four Cultural Festival
平反六四公投|Vindication referendum
邓小平镇压视频|Deng Xiaoping repression video
封从德日记|Letters from Germany diary
89年天安门大虐杀|1989 Tiananmen Square Massacre
2022年平反六四|2022 vindication
六四遗孤|Sixty-four orphans
六四受害者|Sixty-four victims
谈六四吕秀莲|Annette talk sixty-four
六四良心犯|Sixty-four prisoners of conscience
六四人物|Sixty-four figures
香港民运大游行|Hong Kong's pro-democracy march
x事件21周年|x 21 anniversary events
中国64真相|China 64 Truth
89历史真相|89 historical truth
27军镇压|27 military repression
89之民主女神|89 of the Goddess of Democracy
六4四事件|Six four four events
liusi89|
xuechao政治风波|xuechao political storm
赵紫阳集团|Zhao Ziyang Group
赵zi阳集团|Zhao Yang Group zi
六四和解条件|Sixty-four settlement terms
海外六四游行|Overseas sixty-four parade
香港六四大游行|Hong Kong, June 4 parade
日本六四游行|Japan sixty-four parade
六四万人游行|Sixty-four million march
绝食64小时|64 hours hunger strike
流血六四|Bleed sixty-four
北京传单飞扬|Beijing flyer flying
反共地下党|Anti-communist underground
事件民间白皮书|Event folk White Paper
胡耀邦封杀|Hu Yaobang ban
六四纪录片|Sixty-four documentary
六四白皮书|Sixty-four White Paper
89年学运|1989 student movement
六四血卡|Sixty-four blood card
屠杀与中国奇迹|Holocaust and the Chinese miracle
木樨地坦克|Sweetclover tank
纪念民运|Memorial pro
陆肆屠城|Lusi massacre
六部口坦克|Six tanks mouth
六部口屠杀|Six mouth massacre
六四良心|Sixty-four conscience
六四军人|Sixty-four soldier
赵紫阳自传|Zhao autobiography
赵紫阳秘密录音|Zhao Ziyang secret recordings
赵紫阳录音回忆|Zhao Ziyang recording memories
赵紫阳民运|Zhao pro
周舵绝食|Zhou Duo hunger strike
六四四君子|Six hundred forty-four gentleman
21年前的6月4号|June 4 21 years ago
周舵血腥的黎明|Zhou Duo bloody dawn
悼念六四亡魂|June 4th memorial Revenant
64烛光悼念|64 candlelight vigil
平反六四大游行|Vindication Parade
64民主大游行|64 Democracy Parade
悼念六四英灵|June 4th memorial souls
赵紫阳现身广场|Zhao appeared Square
六四伤残者群体|Sixty-four the disabled population
坦克碾压大学生|Tanks rolling Students
中共管制|Communist control
六四永远的伤痕|Sixty-four scars forever
ziyang回忆录|ziyang memoirs
89武力镇压|89 armed suppression
温家宝政治秀|Wen political show
89见证最后的美丽|89 to witness the beauty of the final
89年六四镇压学生|89 students in the June 4 crackdown
王丹要回家运动|Wang Dan to go home sports
事件廿一周年|Twenty anniversary event
阳软禁中的谈话|Yang under house arrest in conversation
阳的最后思考|Yang finally thinking
64tianwang@gmail|
1989recallofmemory|
memoryof1989tiananmen|
tiananmen1989纪录片|tiananmen1989 documentary
民主女神之歌|Song of the Goddess of Democracy
天安门母亲子霖|Tiananmen Mothers sub-lin
六四自辩书|Sixty-four self-defense book
重新评价六四|Reappraisal sixty-four
89年广场上的鲜血|Blood on the square 89 years
89年运动正名|89-year campaign to name
六四公开信|Sixty-four open letter
透视中国六四|Perspective Chinese sixty-four
北京屠城|Beijing massacre
天安门64|Tiananmen Square 64
8964风波|8964 storm
1989序|1989 Order
见证六四|Witness sixty-four
六四绝食书|Sixty-four hunger book
回忆六四|Memories sixty-four
天安门时报|Tiananmen Times
民运连环抄家|Pro serial raid
王丹公开信|Wang Dan open letter
六四戒严部队|Sixty-four martial law troops
胡耀邦平反|Hu Yaobang vindicated
1989见证最后的美丽|1989 witnessed the last of the beautiful
89政治学潮|89 political student movement
淋巴宪章|Lymphatic charter
o捌宪章|O Ba Charter
零八和谐宪章|Harmony and eight charter
零捌线章|Lingbaxianzhang
08线章|Chapter 08 lines
零八线章|And eight lines Chapter
0八线章|Chapter eight line 0
liusi冤魂|LiuSi ghosts
liusi情结|LiuSi Complex
八九运动定性|1989 movement qualitative
picpacknewcn|
picbaiducom|
八x八事件|Eight x eight events
六四挡坦克|Sixty-four block tanks
血祭长安街|Blood Sacrifice Chang'an Avenue
89年天俺门|89 days I doors
6泗学潮|6 Si student protests
89年压死大学生|Students crushed 89 years
邓匪做恶在陆肆|Deng evil bandit in Lusi
六四決要平反|Sixty-four never going to be rehabilitated
1989demonstrationsintiananmen|
陆肆动乱|Lusi unrest
1989年北京实行戒严|Beijing to impose martial law in 1989
89年viiv事件|89 years VIIV event
当残共平九|When the total residue level nine
六四文化衫|Sixty-four shirt
98新疆平叛|98 Xinjiang insurgency
供残谠|Dang for disabled
8九学潮|8 nine student movement
89血潮|89 Blood Tide
北京六月屠杀|Beijing, June massacre
twentyyearsaftertiananmen|
19把9年柳丝|19 9 years Stir
yi9八9年|yi9 eight nine years
liu月4曰|liu said May 4
20年前广场的真相|Square 20 years ago, the truth
six4|
二十周年祭|On the 20th Anniversary
８九年の天門事|8 There are nine things Tianmen
流月4日|Flow January 4
被坦克活活压死|Tanks were crushed to death
88事件20周年|88 20th anniversary event
壹玖捌玖陆肆|Jiu Jiu Ba Lusi
硫死纪念日|Sulfur death anniversary
廿年前|Twenty years ago
38小时的挣扎|38 hours of struggle
曾荫权不代表我|Tsang does not mean I
陆肆游行|Lusi parade
陆肆烛光晚会|Lusi candlelight vigil
追究屠城责任|Investigated the massacre responsibility
天按门血案|Day massacre by the door
某事件20周年|20th anniversary of an event
x事件20周年|20th anniversary of the event x
1989年的六月四日|4 June 1989
中文版改革历程|Chinese version of the reform process
dang中央集权独裁|Dang centralized dictatorship
1989年国内政治风波|1989 domestic political turmoil
20年钱的政治风波|20 years of political turmoil money
赵纸阳的回忆录|Yang Zhao memoirs paper
88民运|88 pro
198空格9民运|198 spaces 9 pro
64北京戒严|64 Beijing martial law
08xianzhan|
89云力乱|89 cloud chaos force
6四20周年|6 four 20th anniversary
8平方纪念日|8 square Day
民运20周年|20th anniversary of the pro-democracy movement
20yearsago|
ershinianqian|
国耻日二十周年|The twentieth anniversary of National Humiliation Day
8的平方快到了|8 square coming
64民运|64 pro
liusi民运|liusi pro
六四日记|Sixty-four diary
紫阳录音|Ziyang Recording
镇压八九|Repression eighty-nine
紫阳幽禁|Ziyang confinement
8的平方就快到了|8 square just around the corner
beijingzhengzhifengbo|
天安m事件|M Cheonan incident
junefour20周年|junefour20 anniversary
贪克压雪胜|Greedy grams pressure snow wins
64北京大屠杀|64 Beijing massacre
89年大学生动乱|Students 89 years of turmoil
中共在一党专制|In an autocratic Communist Party
51月4日|4 March 51
吾尔和谐开希|Ur harmony Kaixi
陆肆20周年|Lusi 20th anniversary
liusi20year|
4x5年前|4x5 ago
马上要64|Soon to be 64
89年学生运动|1989 student movement
1989年的政治風波|1989 political turmoil
1989天安门事变|1989 Tiananmen Incident
june4事件|June4 event
1989年64运动|1989 64 sports
1989年春夏zhi交|1989 spring and summer zhi post
64大学生运动|64 Students Movement
89dong乱|89Dong chaos
89年政治学潮|89-year political student movement
8964纪念日|Memorial Day 8964
为8964平反|Vindication for 8964
89民主事件|89 Democratic events
64天安门闹学潮|64 Tiananmen student strike
89镇压学生|89 suppression of the student
天an门事件|Day an scandal
六四日|Sixty-four Day
六四的鲜血|June Fourth blood
为什么要谈六四|Why should we talk sixty-four
junefourth事件|junefourth event
89年大学生学潮|Students 89 years of student protests
陆肆岷运领袖|Lusi Min Yun leaders
陆肆惨案|Lusi massacre
89年的反官倒学潮|89 years of anti-profiteering student protests
liu四屠殺|liu four massacre
52开希流亡笔记|52 Kaixi exile notes
tian安门事件|tian Tiananmen incident
tiananmen事件20周年|20th anniversary event tiananmen
88风波的反思|Reflection 88 storm
liusi镇压事件|liusi crackdown
捌九轶事|Ba nine anecdotes
捌九陆肆|Ba nine Lusi
赵紫阳六四后|After June Fourth Zhao Ziyang
六四底层列传|Sixty-four underlying Biography
中国劳动党|Chinese Labor Party
tiananmen惨案|TIANANMEN massacre
89年那场风波|That 89-year storm
六四戒严军队|Sixty-four martial law troops
八九年64|2089 64
六四的坦克|June Fourth Tank
天安门绝食|Tiananmen hunger strike
捌久政治风波|Eight years of political turmoil
罢免李鹏总理|Premier Li Peng recall
陸④事件|LU ④ Event
兲鮟閄事件|Tian Shan event monkfish
tiananmensquareprotests|
89年中国学潮|1989 Chinese student protests
89年的倒共风暴|89 years down the total storm
三褪保平安|Three faded security and peace
89年june4|89 years june4
june4二十年|June4 two decades
民运领袖王丹|Democracy leader Wang Dan
六四暴徒|Sixty-four mob
在六四中丧生|Killed in Tiananmen in
六四时期|Sixty-four period
六四画家武文建|Sixty-four painter Wu Wen Jian
二十年后的六四|642 years after
六四市民被枪伤|Sixty-four people were gunshot wounds
中共愚弄国人|CCP fool people
8964屠杀|8964 Massacre
64屠杀事件|64 massacre
89政治风波|89 political storm
希开尔吾|I hope Kelvin
吴而凯西|Wu and Casey
beijingzhengzhi风波|beijingzhengzhi storm
19八9事件|19 eight nine events
学chao事件|Learn chao event
8964学运|8964 student movement
学运人士|Student movement who
宪章08|Charter 08
六四纪念活动|Sixty-four commemoration
八九年动乱|2089 unrest
五加一四运动|Five plus fourteen sports
六四的受害者|June Fourth victims
8九年春夏之交|8 hrs, spring and summer
八九年民主运动|2089 Democracy Movement
six4事件|six4 event
0八贤章|0 eight Yin Zhang
零八贤政|And eight Yin Zheng
零捌贤政|Lingbaxianzheng
08贤政|08 Yin Zheng
0八贤政|0 eight Yin Zheng
0捌贤政|0 Ba Yin Zheng
零捌贤章|Zero Ba Xian Zhang
零八贤章|Yin and eight chapters
零八限章|And eight chapters limit
89protestsintiananmensquare|
08限章|Chapter 08 limit
08先章|08 First Chapter
08贤章|Yin Chapter 08
08闲章|Busy Chapter 08
ling八宪章|ling eight charter
〇八宪章|Square eight charter
〇8宪章|〇8 Charter
08宪张|08 Zhang Xian
零ba宪章|Charter zero ba
0捌宪章|0 Ba Charter
零八宪政|And eight constitutional
零捌宪政|Zero eight constitutional
08宪政|08 constitutional
0八宪政|0 eight constitutional
0捌宪政|0 Ba constitutional
0捌xian章|0 Ba xian Zhang
零八xian政|And eight political xian
08xian政|08xian politics
0八xian政|0 eight xian politics
0捌xian政|0 Ba Zheng xian
零捌xian章|Zero Ba xian Zhang
0八宪脏|0 eight Gazette dirty
0捌县章|0 Ba County Chapter
0八县章|Chapter eight counties 0
零八县政|And eight county government
零捌县政|Zero eight county government
08县政|08 county government
0捌县政|0 Ba county government
0八县政|0 eight county government
零八先政|And eight first political
零捌先政|Lingbaxianzheng
08先政|08 first political
0八先政|0 eight first political
0捌先政|0 Ba Zheng first
零捌先章|Lingbaxianzhang
零八先章|And eight first chapter
0捌贤章|0 Ba Xian Zhang
6月4日的事件|Events of June 4
天安门广场骚乱|Tiananmen Square riots
bj政治风波|BJ political storm
89nian06yue04ri|
六四tusha|Sixty-four Tusha
零捌宪章|Zero eight charter
jiuping共产党|Communist JIUPING
8964邓屠|8964 Deng Tu
三退服务点|Three points back service
liusishijian|
bajiudongluan|
八九民运人士|June incident people
六四屠殺|4 June massacre
捌玖事件|Jiu Ba event
捌玖年春夏之交|Jiu Ba spring and summer
捌玖年的雪潮|Jiu Ba tide in snow
陆肆政治风波|Lusi political storm
charter08|
zhangzuhuaandliuxiaobo|
appearanceofdemocracywallinbei|
studentswhoinstigatedtheprotests|
6肆事件|6 store events
神韵巡演|Charm tour
陆4事件|Lu 4 Event
liusi政治运动|liusi political movement
凌霸县长|Magistrate Pa Ling
淋巴贤章|Zhang Yin lymphatic
淋巴县长|Lymphatic county
八零章宪|Eighty chapters Gazette
6四风波|6 four storm
为64平反|64 vindicated
当年64绝食|64 year hunger strike
89年学运风波|1989 student movement storm
lingba宪章|lingba Charter
六四图片展|Sixty-four exhibition
纪念六四委员会|Memorial sixty-four Committee
天安门政治风波|Tiananmen political storm
8964大屠杀20周年|20th anniversary of the 8964 massacre
六四二十年后|Six hundred forty-two years later
1989年six4|1989 SIX4
1999年flg事件|1999 FLG event
89年北京政治風波|Beijing 89 years of political turmoil
北京事件真相|Beijing truth
天安门的事件|Tiananmen events
89天安门|89 Tiananmen
门屠杀20周年|20th anniversary of the massacre door
89年陆肆|89 years Lusi
从六四到法轮|From sixty-four to Falun
89年的天安门|89 years of Tiananmen
天安门广场绝食|Hunger strike in Tiananmen Square
89年大学生暴动|Students riot 89 years
1989二十周年|The twentieth anniversary of 1989
北京学潮|Beijing student protests
89年那个事件|89 years of the event
纪念八平方|Memorial eight square
八平方运动|Eight square movement
6四事件|6 four events
二十年前八平方|Twenty years ago, eight square
八平方纪念日|Eight square Day
1989年民主抗议活动|1989 democracy protests
20thanniversaryofthejune4|
june41989|
89年夏季的学潮|1989 Summer Student Strike
六四伤残者|Sixty-four handicapped
1989年6月政治风波|June 1989 political turmoil
呼吁为六四平反|June 4 appealed vindicated
血腥镇压了六四|Bloody crackdown sixty-four
为六四平反|June 4 vindication
纪录片天安門|Documentary Tiananmen
中国六四真相|China Tiananmen
89年镇压学生|89 years of suppression of the student
六four事件|Six four events
六四歌曲|Sixty-four songs
中国发生了六四|China has undergone sixty-four
六四死亡人数|Sixty-four deaths
一九八玖六肆|Nine six one hundred ninety-eight store
抓紧三退|Seize three back
六四的民主斗士|June Fourth fighter for democracy
六四民主斗士|Sixty-four fighter for democracy
邓小平屠杀学生|Deng Xiaoping's massacre of students
六四前夕|Eve of 4 June
八9风波|Eight 9 storm
八9年春夏之交|Eight 9-year spring and summer
六四的学潮|June Fourth student movement
游行悼念六四|June 4th memorial parade
8964过后|After 8964
89年暴力镇压民主|89 years of violent repression of democracy
8玖政治风波|8 Nine political storm
毋忘陆肆|Lusi not forgotten
89年的六四|89 June 4
民运大会论六四|Assembly on the pro-democracy movement sixty-four
8964的惨痛|8964 painful
八九年闹腾民运|2089 pro-democracy movement naughty
八9年6四事件|Eight nine six four-year event
19八9年事件|19 eight nine-year event
89年民运|1989 pro-democracy movement
64学潮|64 Student Strike
迴避六四问题|Sixty-four avoid problems
平反赵紫阳|Vindication of Zhao Ziyang
赵紫阳平反|Zhao Ziyang vindicated
年六四期间|During the June 4
八九年陆是学潮|Lu was a student strike in 2089
六四绝食|Sixty-four hunger strike
tiananmensquarein1989|
8964的坦克和机枪|8964 tanks and machine guns
89六四闹事|June 4, 1989 trouble
八九年反腐学潮|2089 Student Strike Corruption
六四反腐败学潮|Sixty-four student movement against corruption
天安门母亲|Tiananmen Mothers
八九年政治活动|Political events in 2089
六四民主大游行|Sixty-four democracy Parade
八九年闹学潮|2089 student strike
liusi事件的学生|Students liusi events
八九年动乱事件|2089 unrest
89年大陆民运|89-year pro mainland
把酒学潮|Wine student protests
屠夫邓小平|Butcher Deng Xiaoping
89年闹学潮|1989 student strike
六四纪念文集|Sixty-four Festschrift
血染了天安门|Bloody Tiananmen Square
六四游行|Sixty-four parade
六四流血惨案|Sixty-four bloody massacre
64学生领袖|64 student leaders
89年的学生运动|1989 student movement
反对中央的独裁|Central oppose dictatorship
89年反腐败要民主|89-year anti-corruption want democracy
89年學潮|89 years of student protests
6四的大动乱|6 four major upheaval
89年那一场风波|89 years that a storm
六二绝食宣言|Sixty-two Hunger Strike Declaration
89年大屠杀|1989 Massacre
纪念六月四日|Commemorate June 4
从反右到六四|From a rightist sixty-four
六四等近代史实|Sixty-four real modern history, etc.
89年64动乱|89 years 64 unrest
北京88事件|Beijing 88 events
六四天安门风波|Tiananmen crisis
1989massacreintiananmensquare|
六四受难者|Sixty-four sufferer
京报刊六四照片|Beijing newspapers sixty-four photo
1989年政治风暴|1989 political turmoil
天安门学运|Tiananmen student movement
打倒李鹏|Down with Li
北京民运|Beijing pro
镇压民运|Suppression of pro-democracy
64学生运动|64 student movement
一九八九年民运|1989 pro-democracy movement
六四天網|Tianwang
天安门示威|Tiananmen demonstrations
高校自治联合会|Federation of University Autonomy
六四风暴|Sixty-four storm
中央解密机密|Central decrypt secrets
毋忘64|Not to forget the 64
六四学生爱国|Sixty-four students'Patriotic
89年的不幸事件|89 years of unfortunate events
89年的镇压|89 years of repression
六四平暴|Sixty-four riot
六四血腥屠杀|Sixty-four bloody massacre
六四烛光晚会|Sixty-four candlelight vigil
六四烛光纪念|Sixty-four Candlelight Memorial
tiananmenmassacre|
八九镇压|Eighty-nine repression
学潮事件|Student strike incident
89民运|89 pro
天安门民主运动|Tiananmen Square democracy movement
六4事件|Six 4 Event
89戒严|89 curfew
tiananmensquaremassacre|
1989年大学生绝食|1989 college students on hunger strike
声明退出保平安|Denounce security and peace
六4学运|Six 4 student movement
六四学运|Sixty-four student movement
八九年风波|2089 storm
89学潮|89 Student Strike
六四档案|Sixty-four Archives
六四天安门事件|Tiananmen Incident.
六四亊件|Sixty-four 亊 pieces
八九年的学潮|2089 student movement
89年进京镇压动乱|Beijing to suppress unrest in 89 years
1989年的四六事件|1989 April 6 Incident
89年事件|89-year event
六四政治风波|Sixty-four political storm
八九年六四|June 1989
六四大屠杀|June 4 massacre
中共血腥镇压|CCP bloody crackdown
1989年六x事件|1989 six X events
十九年前学潮|Nineteen years ago a student strike
声援学生绝食|Solidarity with the students on hunger strike
天安门的屠杀|Tiananmen massacre
bajiu年学潮|bajiu year student protests
1989年的x四事件|1989 X four events
八九政治风波|Eighty-nine political storm
1989年的六4事件|1989 Six 4 events
89年64风波|89 years 64 storm
邓贼|Deng thief
六四民主运动|Sixty-four democracy movement
天安门风波|Tiananmen crisis
四君子绝食|Sijunzi hunger strike
6四学潮|6 four student protests
1989年天x门广场|1989 days x Gate Square
六四镇压|The crackdown
1989年事件|1989 Event
八九动乱|Eighty-nine unrest
镇压六四|Repression sixty-four
bloodisonthesquare|
平反六四|Vindication
纪念六四|Memorial sixty-four
64风波|64 storm
八九风波|Eighty-nine storm
89风波|89 storm
六四血案|Sixty-four murder
天安门大屠杀|Tiananmen Square Massacre
六四军事政变|Sixty-four military coup
六四屠城|Sixty-four massacre
天安门受难人|Tiananmen suffering people
六四回忆录|Sixty-four memoirs
血洗天安门|Tiananmen bloodbath
天安门旧魂新魄|Tiananmen Jiuhunxinpo
xuechao|
64事件|64 events
64运动|64 sports
六四运动|Sixty-four sports
89年政治风波|89 years of political turmoil
六四动乱|Sixty-four unrest
89年动乱|89 years of turmoil
1989年动乱|1989 unrest
六四天网|Tianwang
六四照片|Sixty-four photo
赵紫阳被软禁|Zhao was placed under house arrest
李金平被捕|Li Jinping arrested
89事件|89 events
64时期|64 times
89时期|89 times
八九时期|Eighty-nine period
八九事件|Eighty-nine event
六四刽子手|Sixty-four executioner
8964屠杀学生|8964 student massacre
天安门屠杀学生|Tiananmen Square massacre of students
0八宪章|0 eight charter
零8宪章|And 8 of the Charter
悼念六四|June 4th memorial
中共屠杀的学生|Communist student massacre
64影片|64 videos
89影片|89 videos
89年春夏之交|Spring and summer 1989
解决64|Solve 64
64真相|64 Truth
64和解|64 Reconciliation
六四原因|Sixty-four reason
六四活动|Sixty-four Activities
解决六四|Solve sixty-four
六四和解|Sixty-four reconciliation
89年的春夏之交|1989 spring and summer
六四和解委员会|Sixty-four Reconciliation Commission
外媒提六四问题|Foreign media mention sixty-four problem
寻访六四受难者|Victims of searching sixty-four
1989大学生事件|1989 Students Event
1989年春夏政治风波|1989 spring and summer of political turmoil
1989北京事件|1989 Beijing event
1989风波|1989 storm
1989事件|1989 Event
1989学潮|1989 student protests
1989年政治风波|1989 political turmoil
邓小平1989|Deng Xiaoping 1989
1989年天安门事件|1989 Tiananmen Square massacre
1989天安门事件|1989 Tiananmen Incident
天安门1989|Tiananmen 1989
19890604事件|19,890,604 event
19890604北京事件|19,890,604 Beijing event
198964风波|198,964 storm
198964事件|198,964 event
天安门自焚|Tiananmen Square self-immolation
89的惨痛|89 painful
64的惨痛|64 painful
89屠杀|89 massacre
64屠杀|64 massacre
89学运|89 student movement
64学运|64 student movement
64惨案|64 tragedy
六四惨案|Sixty-four massacre
64戒严|64 curfew
六四戒严|Sixty-four martial law
一九八九六四|One hundred ninety-eight thousand nine hundred sixty-four
sixfour事件|sixfour event
20年前6月4日|20 years ago, June 4
天安门枪杀|Tiananmen Square shootings
江婴诗存|Jiang infant Poems
xue潮|xue tide
1989年6月四日|June 4, 1989
1989年六月4日|June 4, 1989
1989年六月四日|June 4, 1989
1989政治风波|1989 political storm
89政治|89 political
89运动|89 sports
liousi事件|liousi event
七十天大事记|Seventy days Memorabilia
89的六月肆号|June 89 store numbers
89事变|89 Incident
89dongluan|
70天大事记|70 days Memorabilia
六四天安门|Tiananmen
六四烛光集会|Sixty-four candlelight vigil
六四中共暴行|Sixty-four Communist atrocities
1989年的学潮|1989 Student Strike
1989年民运|1989 pro-democracy movement
1989年六四|June 4, 1989
1989年学潮|1989 Student Strike
1989反革命|1989 counterrevolution
1989革命|1989 Revolution
1989天安门暴动|1989 Tiananmen Square uprising
1989天安门民运|1989 Tiananmen Square pro-democracy movement
1989中国大事件|1989 Chinese Grand Event
1989大学生造反|1989 Students revolt
1989政治动乱|1989 political unrest
1989年风波|1989 storm
1989年学生动乱真相|1989 student unrest truth
1989年学潮视频|1989 Student Strike Video
1989学生运动|1989 student movement
1989反革命暴乱|1989 counterrevolutionary riot
1989大学生民主革命|1989 Students' Democratic Revolution
天和安谐门事件|An harmonic door event day
天安men事件|Men Cheonan incident
陆百度肆|Lu Baidu store
1九吧9|A nine bar 9
血巢事件|Blood Nest Event
1989tam|
学和谐chao|Learn harmony chao
陆4英魂|Lu 4 souls
豺龄|Jackal age
遛越寺日|Liuyuesiri
纪念柳丝|Memorial Stir
毋忘六四|Not to forget sixty-four
六四纪实|Sixty-four documentary
平反八九民运|Vindicate the pro-democracy movement
天安门镇压事件|Tiananmen crackdown
陆四事件|Lu four events
耀bang|Yao-bang
tam母亲|tam mother
64英魂|64 souls
六四英魂|Sixty-four souls
件事四六|Thing forty-six
陆肆风波|Lusi storm
陆肆事件|Lusi event
六④20年祭|Six years of sacrifice ④20
4学运的内幕真相|Insider Truth 4 student movement
june4th89|
89共和国卫士|89 Republic Guard
89年民主运动|1989 Democracy Movement
89年64|64 89 years
89年的动乱|89 years of turmoil
89动乱|89 unrest
64大屠杀|64 massacre
莫少平|Mo Shaoping
黄琦被捕|Huang Qi was arrested
木樨地大屠杀|Sweetclover Holocaust
liusi事件|liusi event
一久八久|A long eight years
五月35号|May 35
八九大学生爆动|Students riot eighty-nine
溜月4日|Slip January 4
8九6四|Eight nine six four
631事件|631 events
柴百度玲|Baidu Chai Ling
柴和谐玲|Chai Ling harmony
六四坦克|Sixty-four tank
一九8玖年|Nine years nineteen 8
tianan门事件|tianan scandal
1989年6yue四日|6yue 24, 1989
daysafedoor|
刘月寺日|Liu Yue Temple Day
4420事件|4420 Event
贰⑩年|II ⑩ years
天鞍们|They saddle day
天按扪事件|Day by palpable event
zhenyadaxuesheng运动|zhenyadaxuesheng sports
20和谐年|20 Harmony
sky安do0r|An do0r sky
liu月4日|liu March 4
八9动乱|Eight nine unrest
6河蟹4|6 crab 4
6月百度4|Baidu June 4
六月河蟹四|June crab four
6月河蟹4|June 4 crab
六月百度四|June Baidu four
陆4学朝|Lu 4 toward school
吴儿开西|Wu children open West
尔吾开西|I opened the West Seoul
八合谐九|Eight nine harmony
纪念liusi|Memorial liusi
六驷屠杀|Six Si massacre
64二十周年|64 twentieth anniversary
89陆十四|89 Miss fourteen
爸课油型|Dad oil-lesson
六越似日|Liuyuesiri
北京血潮|Beijing blood tide
89年坦克无情|89 years of relentless Tank
student河蟹潮|crab student influx
6死实践|6 dead Practice
六si事件|Six si event
胡耀和谐邦|Yao Hu harmonious state
捌玖年陆月肆日|Nine months in Ba Lu wantonly Day
六丝事件|Six wire event
勿忘64|Forget-64
20年前柳丝|20 years ago Stir
6和谐4|Harmony 4 6
陆肆2o周年|Lusi 2o anniversary
柳丝运动|Stir sports
北京暴乱|Beijing riots
89学生运动|89 student movement
天按们|Days by their
己巳国殇|Baba War
天安门是件|Tiananmen Square is a
六四襟章|Sixty-four Badge
田暗门思件|Tian trapdoor think pieces
89shi件|89shi pieces
六四天安門|Tiananmen
6four事件|6four event
八久雪巢|Bajiuxuechao
捌玖年天暗们|Nine years have Ba Tian
广场坦克事件|Square tanks event
柳丝20周年|Stir 20th anniversary
陆肆自由运动|Lusi freedom movement
5yue35ri|
19890604|
6s事件|6s event
爸舅年事件|Dad uncle Event
土旦克艽言平|Dankejiaoyan flat earth
89年六月初四|On the fourth day, June 89
①勼仈勼姩|① Jiubajiunian
89xuechao|
8平方事件|8 square Event
党向学生开枪|Party to students shot
天安门惨案|Tiananmen massacre
tank门|tank door
thegateofheavenlypeace|
平翻64|Flat turn 64
64动和谐乱|64 move in harmony chaos
舒克和大学生|Shook and college students
tam前压路机|tam front roller
89年到底怎么|89 years in the end how
8的平方那天|Day 8 square
liu4xue潮|liu4xue tide
tam聚会|tam gatherings
8乘以8事件|8 multiplied by 8 events
高某联|High of a Union
天某门事件|Day of a scandal
six月four号|six months four numbers
克坦动出敢|Kodan dare move out
陆风四波|Landwind four-wave
血洗京城|Bloodbath capital
屠沙学生|Tu sand student
历史的大爆炸|History of the Big Bang
prisonerofthestate|
平反64|Vindicated 64
怀念6四|Miss six four
怀念六4|Miss six 4
怀念6月4|Miss the June 4
怀念6月四|Miss the June 4
怀念六月4|Miss the June 4
怀念六月四|Miss the June 4
缅怀6四|The memory of 6 four
缅怀六4|Cherish the memory of six 4
缅怀六四|Nostalgia sixty-four
缅怀6月4|Cherish the memory of June 4
缅怀6月四|Cherish the memory of June 4
缅怀六月4|Cherish the memory of June 4
缅怀六月四|Cherish the memory of June 4
缅怀64|Nostalgia 64
怀念64|Miss 64
怀念六四|Miss sixty-four
6四怀念|6 four missed
六4怀念|4 miss six
六月4怀念|June 4 miss
六月四怀念|June 4 miss
6月4怀念|June 4 remembrance
6月四怀念|June 4 remembrance
64怀念|64 missed
六四怀念|Sixty-four miss
6四纪念|6 four Memorial
64信息|64 Information
六月4纪念|June 4 Memorial
六月四纪念|June 4 Memorial
6月4纪念|June 4 Memorial
6月四纪念|June 4 Memorial
64纪念|64 Memorial
六月四日纪念|June 4 Memorial
6月4日纪念|June 4 Memorial
6月四日纪念|June 4 Memorial
纪念6四|Memorial six four
纪念六月4|Commemorate June 4
纪念六月四|Commemorate June 4
纪念6月4|Commemorate June 4
纪念6月四|Commemorate June 4
绿月肆日|Lvyuesiri
尔吾希开|Erwuxikai
6四真相|6 Four Truths
6四运动|6 four sports
八的平方事件|Eight square event
2×10年前的事|2 × 10 years ago
六屎事件|Six feces event
8的平方事件|8 square event
添安闷事见|Tim Ann boring thing to see
陆4学运|Lu 4 student movement
i989陆4|i989 land 4
陆4运动|Lu 4 Movement
捌9年6肆|Ba 9 June wantonly
8*8事件|8 * 8 events
8玖年柳月食日|Nine years 8 Willow eclipse day
壹九8玖|One nine eight Nine
64重演|64 repeat
tiananmensquare|
六4学朝|Six four school towards
八9学朝|Eight 9 toward school
6四学朝|6 towards four school
8九学朝|8 towards nine school
tam事件|tam event
八九年6月4日|June 4, 2089
⑥肆运动|⑥ wantonly sport
②⑩zhou年|②⑩zhou years
天按door|Day by door
89学朝|89 toward school
学朝运动|Movement toward school
陆肆餐安|Lusi food safety
89t安门|89t Yasukado
柳丝民运|Stir pro
天x门事件|Day x scandal
添安门|Tim Yasukado
t安门zf|t Tiananmen zf
刘四田安门|Liu Tian four Yasukado
吾尔剀西|Ur Kelly West
学生挡坦克|Students block tanks
肉身挡坦克|Tank body block
肉阻挡坦克|Meat stop tanks
52开洗|52 open wash
6四8九|Six four eight nine
刘四事件|Liu four events
52kaixi|
52开希|52 Kaixi
胡妖邦|Hu Yaobang
五尔开希|Five Seoul Kaixi
刘月四号|Liu fourth month
铭记6四|Bearing in mind the six four
64内部日记|64 internal diary
64日记|64 Diary
六四内部日记|Sixty-four internal diary
捌玖陸肆|Jiu Ba Lusi
北京动乱|Beijing unrest
广场上的鲜血|Blood on the square
liusi记录片|liusi documentary
六四的内幕|June Fourth Insider
bajiushibian|
天安们事变|Tiananmen Incident
64事变|64 Incident
8加9事件|8 plus 9 events
不能忘却的纪念|Can not forget the Memorial
国家的囚徒|Prisoner countries
国家的囚犯|Prisoners countries
64动百度乱|64 move Baidu chaos
六和谐四|Six harmonious four
s1xf0ur|
陆玥肆|Lu Yue store
天和谐安|An harmonious day
tiananmen绝食|tiananmen hunger strike
89年某位画圈|Reviewed by a circle 89 years
学百度潮|Learn Baidu tide
学和谐潮|Learn harmony tide
学河蟹潮|Learn crab tide
89年的6月4日|1989 June 4
胡和谐耀|Hu Yao harmony
波风四六|Wave Wind forty-six
89年6和4|89 June and 4
89年学x|89 years of schooling x
tiananmen事件|tiananmen event
六河蟹四|Six crab four
六百度四|Six Baidu four
捌96肆|96 Ba store
天安door|Tian door
六月和谐四日|June 24, Harmony
柳丝事件|Stir event
tankman|
8x8运动|8x8 sport
8x8事件|8x8 Event
20年薪火|20 salary fire
64伤痛历史|64 pain history
六四烛光|Sixty-four candlelight
六四感言|Sixty-four reflections
陶君行|Tao Jun-line
薪火相传|Passing the torch
灵吧线张|Zhang Ling Bar Line
零/八/宪/章|Zero / eight / Constitution / Chapter
sky按们|sky by their
33月22号|33 May 22
33月22日|33 May 22
八九暴动|Eighty-nine riots
八九暴乱|Eighty-nine riots
89暴乱|89 riots
六四暴乱|Sixty-four riots
六四暴动|Sixty-four riots
六四平反|Sixty-four vindicated
六四枪击|Sixty-four shootings
六四枪杀|Sixty-four shot
八乘八事件|Eight by eight events
8乘8事件|8 by 8 events
6四20year|6 four 20year
中国大虐杀史|Massacre History of China
天安门大虐杀|Tiananmen Square Massacre
天安门白t恤|Tiananmen white T-shirt
20周年大游行|20th Anniversary Parade
民运大游行|Pro-democracy march
坦克碾压学生|Tanks rolling student
64学生坦克|64 students in the tank
三十八军军长|Thirty-eight Corps
三十八军长|Thirty-eight commander
军长徐先勤|Commander Xu Xianqin
紫阳回忆录|Ziyang memoirs
64文化传播|64 Cultural Communications
六四文化传播|Sixty-four cultural communication
64文化祭|64 Cultural Festival
六四文化祭|Sixty-four Cultural Festival
6420周年|6420 anniversary
民运手册|Pro manual
秘密录音回忆录|Secret recordings memoirs
六四万岁|Viva sixty-four
64万岁|64 Viva
六四之殇|Sixty-four Shame
64之殇|64 of Shame
1989那事|1989 that thing
大学生事件|Students Event
1989历史|1989 History
天安事件|Cheonan incident
89记录片|89 documentary
天安门大事|Tiananmen events
遛寺事件|Stroll the Temple event
溜寺事件|Temple slip event
李卓人|LEE
罗沃启|Kemerovo Kai
二十一周年游行|Twenty-one anniversary parade
21周年游行|21 anniversary parade
悼念6四|Mourn six four
悼念六4|Mourn six 4
悼念64|Tribute to 64
焚烧中共党旗|Communist party flag burning
司徒华|SZETO
21年前天安门|Tiananmen Square 21 years ago
天安门屠杀浮雕|Tiananmen massacre relief
6421周年|6421 anniversary
六四二十一周年|Twenty-one Tiananmen anniversary
六四21周年|21 anniversary sixty-four
天安门暴乱|Tiananmen Square riots
64年事件|64-year event
纪念8964|Memorial 8964
1989年学运|1989 student movement
红都大纪实|Red Grand documentary
赵紫阳被撤销|Zhao Ziyang was revoked
赵紫阳的回忆录|Zhao Ziyang's memoirs
六四前后的杀戮|Tiananmen killings before and after
天安门流血事件|Tiananmen bloodshed
李鹏六四|Li sixty-four
西厢计划|West Wing plan
64血案|64 murder
liu小波|liu wavelet
liuxiao波|liuxiao wave
刘小bo|Liu BO
刘晓bo|Liu BO
刘xiaobo|Liu xiaobo
刘1晓1波|Liu Xiao wave 1 1
刘x晓x波|Liu Xiao X X wave
刘x波|Liu x wave
xb得奖|XB Winners
xiaobo得奖|xiaobo Winners
晓波得奖|Xiaobo winning
小波得奖|Wavelet Winners
晓波坐牢|Xiaobo jail
小波坐牢|Wavelet jail
刘小b|Liu B
刘晓拨|Liu dial
刘晓b|Liu b
流筱波|Xiao wave flow
柳晓波|Liu Xiaobo
留晓波|Stay Xiaobo
留小波|Wavelet stay
刘笑波|Liu Xiaobo
波小刘|Liu wave
刘日尧水皮|Liu Yao-day water skin
刘日尧三皮|Liu Yao-day three leather
流晓波|Flow Xiaobo
赵子阳|Zhao Ziyang
liuxiaobo|
1989六月四日|4 June 1989
89真相|89 Truth
1989发生的事|1989 things happen
6month4day|
89年6月发生的事|What happened on June 89
four惨案|four massacre
four运动|four sports
four事件|four events
sixfour|
89年的那次事件|89 years of the incident
陆月肆日|Luyuesiri
89年的那件大事|89 years of that great
89学生风暴|89 students storm
1989年的暴乱|1989 riots
六罒|Six 罒
学生在广场静坐|Student sit-in in the square
春夏之交的动乱|Spring and summer of unrest
89年的学朝|89 years of study toward
一把青云|An Albatron
89的大事|89 event
89有政治事件|89 political events
带部队杀大学生|Students with troops killed
89发生了什么事|What happened 89
89年发生的事|What happened 89 years
天安门上的集会|Rally on Tiananmen Square
死于八乘八|Died eight by eight
过敏当|When allergies
贡铲当|When shoveling tribute
20年前的破事|20 years ago, broken things
谭zr|Tan ZR
薪糖人|Pay Sugar
螳臂当车八乘八|Mantis arm when the car is eight by eight
bajiu年|bajiu years
21年前的乱局|21 years of chaos
eightnine动乱|eightnine unrest
二十一年前广场|Square 21 years ago
25年前六月|25 years ago in June
二十捻前|Twenty twist ago
25年前春夏之交|25 years ago, spring and summer
25年前的那件事|That thing 25 years ago
田安们|Tian who
bajiu事件|BAJIU event
89雪巢|89 snow nest
八九雪巢|Eighty-nine snow nest
liusiyundong|
纪录片天安门|Documentary Tiananmen
square事件|Square event
anmen事件|anmen event
6月4号动乱|June 4 unrest
1989的事|1989 things
六四学朝|Sixty-four toward school
学chao|Learn CHAO
八九年发生的事|What happened in 2089
八九惨案|Eighty-nine massacre
北京大学生暴动|Beijing Student Riots
tam学生|TAM students
89的大学生风波|89 students storm
6si运动|6si sports
六寺事件|Six Temple Event
89年的示威游行|89 years of demonstrations
20年前大学生闹事|Students trouble 20 years ago
江泽民其人|Jiang its people
中国政治风波|Chinese political storm
天安门广场静坐|Tiananmen Square sit-in
天安门发生事件|Tiananmen incident
89颜色革命|89 color revolution
小平杀害大学生|Xiaoping killed Students
猪的哲学|Philosophy pig
邓小平变法|Deng Xiaoping's reform
柴灵|Chai Ling
1989年发生了什么|What happened in 1989
绝食的政治事件|Hunger strike of political events
天安门六四|Tiananmen sixty-four
全球倒共|Total global fall
民主中国阵线|Democratic China
paltalks|
操女小穴|Exercise female pussy
珍藏黄网|Huang collection network
全魔法伦|London full of magic
siddiq-lar|
视频做爱|Video sex
骚女q|Sao female Q
骚女做爱|Sao female sex
做爱大片|Sex blockbusters
车模做爱|Cars sex
q3669079|
扣逼 流水|Buckle force water
刘乐飞|Mr Liu
留云山|Stay Yunshan
刘氏父子|Liu and his son
红十字商会|Red Cross Chamber of Commerce
政治局常委|Politburo Standing Committee
博爱小站|Fraternity station
删帖|Delete posts
刘源|Liu Yuan
郭伯雄|Guo
徐才厚|Xu
钟绍军|Zhongshao Jun
6700亿|670000000000
3400亿|340000000000
五十名中将|Fifty Lieutenant
50名中将|50 Lieutenant
军头私分|Army dividing head
五百公斤黄金|Five hundred kilograms of gold
谷俊山现象|Gu Jun Shan phenomenon
倒卖军火|Sales of arms
买官卖爵|Buying and selling MG
乱军亡政|Creating chaos political death
贪污军产|Corruption and military products
军委深改组|Deep restructuring of the Central Military Commission
贾庆l|Jiaqing L
异地关押|Remote detention
解放军38师|People's Liberation Army 38 division
呼市sh狱中|Hohhot SH prison
宋zu英|SONG ZU English
宋祖y|SONG Zu Y
双重调查|Dual investigation
违规动用军费|Illegal use of military
金色艺术团|Golden Troupe
美国神韵艺术团|US Divine Performing Arts
镀金现象|Gilded phenomenon
中共前党魁|Former Communist leader
失势风向标|Downfall weathervane
淫乱李瑞英|Promiscuous Ruiying
万庆良|Wanqingliang
狼咸平|Wolf Xianping
谷俊山|Gu Jun Shan
宋国母|Mother Song
江蛤蛤|River clams clams
邓朴方|Deng
鄧樸方|Deng
鄧小平|Deng Xiaoping
刘绍喜|Liu Shaoxi
宜华董事长|Yihua chairman
巨额军费|Huge military
李瑞英|Ruiying
islamawazi|
taliban|
turkisitan|
özbékistan|
bazarteshkilati|
elqaideteshkilati|
abdullah|
silam-awazi|
islam_awazi|
türkistan|
ijiret|
﻿hijirat|
ijirat|
jundula|
jundila|
jundile|
jundule|
gundila|
gundile|
gundule|
saddiqlar|
gihad|
jihed|
gihed|
shehad|
shehid|
shihad|
sihid|
sihad|
xahadet|
xihadit|
jahid|
jtahit|
jiaxid|
jiahet|
jiahit|
izabet|
izabit|
izabut|
uygursitan|
yunnandiki|
musulmanlirigha|
muminlernig|
jamaet|
oygan|
qurultiyning|
allahning|
turkistangha|
möminlerning|
kelmidim|
qurbanliq|
bolsam|
yolwasliri|
xutbisi|
turmisidiki|
iqinixlik|
tajawuzchiliri|
yetküzüng|
ashiqliri|
muminlerning|
qérindishim|
nesihiti|
bayanat|
yollanmiliri|
koshuni|
qilghan|
qelbimizning|
buddistlar|
héyitliq|
partlitkuch|
xilawet|
emeliyet|
awazi|
ھىجرەت|
شەھىد|
ىزابەت|
مۇھمىنلەرنىڭ|
ئاساسلىرى|
دەۋىتى|
جاھىد|
كەلدۇق|
ئالسۇن|
jundulla|
siddiqlartv|
siddiqlar|
جۇندۇللا|
ئانا|
tajawoz|
虐待中国妇女的|Chinese women's abuse
中共江派|CCP Jiang faction
红会美美|Red Mimi
hulkshare|
党派之争|Partisanship
islam awazi radiosi|
مۆمىنلەرنىڭ ساياھىتى|
möminlerning sayahiti|
英雄已失去音信|Hero has lost news
batur(atalmaq üchün kelmidim|
ئىسلام دىنى قۇربانلىق دىنى|
我若是殉教|If I Martyrdom
shehid bolsam|
شەھىد بولسام|
圣战雄狮|Jihad Lions
jeng yolwasliri|
جەڭ يولۋاسلىرى|
突厥斯坦圣战|Turkestan jihad
turkistan mujahidliri|
اھىدلىرىمىز شەرقى تۈركىستان|
古尔邦节讲道|Eid al-Adha sermon
qurban héyit xutbisi|
قۇربان ھېيىت خۇتبىسى|
我们是圣战者|We are jihadists
mujahidlirimiz|
مۇجاھىدلىرىمىز شەرقى تۈركىستان|
库尔邦节圣训|Courban section Hadith
-يىللىق قۇربان ھېيىت|
中共监狱|Communist prison
hitay turmisidiki iqinixlik eslimiler|
خىتاي تۈرمىسىدىكى ئېچىنىشلىق ئەسلىمىلەر|
sherqi türkistan jihadning hökümi|
mendin yetküzüng i ata!|
مەندىن يەتكۈزۈڭ ئى ئاتا!|
钟爱天堂的人|Love to heaven
jennet ashiqliri 8-qisim|
جەننەت ئاشىقلىرى 8-قىسىم|
来吧，我的兄弟|Come on, my brother
kel qérindishim|
xalid hüseyinning sherqi türkistan musulmanlirigha qilghan nesihiti|
خالىد ھۈسەيىننىڭ شەرقى تۈركىستان|
maralbéshi siriqbuyida élip bérilghan jihadi emeliyet toghrisida bayanat|
胜利或殉教|Victory or Martyrdom
军事快件|Military shipments
托卡列夫手枪|Tokarev pistol
马卡洛夫手枪|Makarov pistol
كىستان ئىسلام پارتىيىسى ئەسكىرى تېز|
cf98-9手枪|CF98-9 pistol
rpg7火箭筒|RPG7 rocket launcher
简易火柴炸弹|Easy matches bomb
事业的军队|Military career
biz bu kesipning koshuni|
ىز بۇ كەسىپنىڭ قوشۇنى|
teyyarliq toghrisida|
ەييارلىق توغرىسىدا|
艾布穆罕默德|Abu Mohammed
ebu muhemmed türkiyidin|
ئەبۇ مۇھەممەد تۈركىيىدىن مۇجاھىدلارغا|
天堂恋人|Lovers Paradise
jennet ashiqliri|
جەننەت ئاشىقلىرى|
osman baturning|
塔里甫|Tarifa just
وسمان باتۇرنىڭ ئىسلامى تۈركىستان مەدىرسىسى قىلغان دەۋىتى|
为正道献身|Devotion to the right path
alle jolnda özin baylaw|
اللە جولندا ئۆزىن بايلاۋ|
关于真理|About Truth
aqyqatti jasirmaw turasinda|
ئاقيقاتتى جاسىرماۋ تۇراسىندا|
战斗的狮子|Fighting Lions
islam qelbimizning töridin orun alsun|
ئىسلام قەلبىمىزنىڭ تۆرىدىن ئورۇن ئالسۇن|
努热提丁|Nu hot 提丁
nuriddin|
نۇرىددىن رخمە ئاللە نىڭ نەسىھىتى ۋە|
关于圣战|About Jihad
jihad heqqide qisqiche chüshenche|
جىھاد ھەققىدە قىسقىچە چۈشەنچە|
jamaet nizamnamisi|
جامائەت نىزامنامىسى|
chüshen ana oghlungni|
چۈشەن ئانا ئوغلۇڭنى|
sheklenme mujahid|
شەكلەنمە مۇجاھىد|
buddistlar,biz kelduq|
ۇددىستلار، بىز كەلدۇق|
阿语版本|Arabic version
türkistan islam partiyisi eskiri téz yollanmiliri 2|
تۈركىستان ئىسلام پارتىيىسى ئەسكىرى تېز|
卡得尔•牙甫泉|Card Fu Quan Seoul • Teeth
吾斯曼•巴特尔|I Klinsmann • Battle
abdulla mansurning|
روزى ھېيىتلىق قىلغان دەۋىتى|
阿布扎尔|Abu Zar
索马里圣战者|Somali jihadists
somali mujahidlirigha|
سومالى مۇجاھىدلىرىغا|
abdulla mansurning rozi héyitliq qilghan dewiti|
وزى ھېيىتلىق قىلغان دەۋىتى|
partlitkuch yasash derisiliki|
پارتلىقۇچ ياساش دەرسلىكى|
安拉路上的迁徙|Migratory path of Allah
sherqi türkistanda élip birilghan jihadiy emeliyetler toghirsida|
شەرقى تۈركىستاندا ئېلىپ بىرىلغان جىھادىي|
alle yolida hijret|
ئاللە يولىدا ھىجرەت|
殉教者的品德|Moral martyrs
شاھادەتنىڭ پەزىلىتى توغرىسىدا|
中巴友谊|Pakistani friendship
哈里发基础|Caliph foundation
xilawet asasliri|
خىلاۋەت ئاساسلىرى|
巨大的成功|Huge success
ulug helbe|
叙利亚圣战|Jihad in Syria
diyaridiki mujahidlirimizgha nesihet|
شام دىيارىدىكى مۇجاھىدلىرىمىزغا نەسىھەت|
天安门圣战|Tiananmen jihad
tyen'enmén meydanida élip bérilghan jihadi emeliyet toghrisida bayanat|
ېيجىڭ تيەنئەنمېن مەيدانىدا ئېلىپ|
真理不可掩盖|Truth can not hide
heqni yushurmasliq toghirsida alimlargha nesihet|
ەقنى يۇشۇرماسلىق توغىرسىدا ئالىملارغا|
nusret achquchining üch chishi|
ۇسرەت ئاچقۇچىنىڭ ئۈچ چىشى|
tablihi|
جىھاد تابلىھى(2)--غەلبىنىڭ شەرتلىرى|
伟大的呼罗珊|Great Khorasan
biz we guzel xorasan|
بىز ۋە گۇزەل خوراسان|
herqi turkistan ezmetliri bizning sepke qitilinglar|
شەرقى تۇركىستان ئەزمەتلىرى بىزنىڭ سەپكە قىتىلىڭلار|
مۇھمىنلەرنىڭ ساياھىتى|
高加索圣战|Caucasus jihad
kavkaz jihadchilirigha xet|
كاۋكاز جىھادچىلىرىغا خەت|
心爱的东突|Beloved East Turkistan
hokumitining uchunchi turkum tirorluk tizimlikige qarita bayanat|
خىتاي ھوكۇمىتىنىڭ ئۇچۇنچى تۇركۇم تىرورلۇك تىزىملىكىگە قارىتا بايانات|
sherqi turkistangha chin muhebbet|
شەرقى تۇركىستانغا چىن مۇھەببەت|
安拉的恩赐|Allah's gift
allahning sowghisi|
ئاللاھنىڭ سوۋغىسى|
birliship ilip barghan jihad herkiti bilen yalghuz jihad herkitining perqi|
بىرلىشىپ ئىلىپ بارغان جىھاد ھەركىتى بىلەن يالغۇز جىھاد ھەركىتىنىڭ پەرقى|
dunya uyghur qurultiyning tot chong qararigha bayanat|
دۇنيا ئۇيغۇر قۇرۇلتىينىڭ توت چوڭ قارارىغا بايانات|
乌伊运|Uy shipped
君都拉制片厂|Jun dragged studio
热爱天堂|Love paradise
جامائەت،ھىجىرەت ۋە جىھاد چۇشەندۇرۇش توغۇرىسىدا|
土耳其穆斯林|Muslim Turkey
turkye musulmanlirigha neseet|
تۇركيە مۇسۇلمانلىرىغا نەسەئەت|
土耳其斯坦|Turkestan
allh yolida jihad qilwatqan musulmanlar we turkistan xelqighe|
ئاللھ يولىدا جىھاد قىلۋاتقان مۇسۇلمانلار ۋە تۇركىستان خەلقىغە|
忠爱天堂|Loyal love paradise
yunnandiki mubarek jihadimiz|
云南的伟大圣战|Great jihad in Yunnan
يۇنناندىكى مۇبارەك جىھادىمىز|
alte tirrorluq sin lintisi|
لتە تىررورلۇق سىن لىنتىسى|
东突伊斯兰党|East Turkistan Islamic Party
sherqi turkistan islam partiyisining sepsanilirige qarita|
شەرقى تۇركىستان ئىسلام پارتىيىسىنىڭ سەپسانىلىرىگە قارىتا|
东突圣战者|East Turkistan Mujahideen
jihad sinnalghusi|
جىھاد سىننالغۇسى|
sherqi turkistan mujahidlirining meshiq ehwali|
شەرقى تۇركىستان مۇجاھىدلىرىنىڭ مەشىق ئەھۋالى|
turkistan islam partiyisining|
شەرقى تۇركىستان ئىسلام پارتىيىسىنىڭ|
sherqi turkistanni oz aldigha bolushqa kuch chiqirwatqan her qaysi siyasi partiyelerge bayanat|
شەرقى تۇركىستاننى ئوز ئالدىغا بولۇشقا كۇچ چىقىرۋاتقان ھەر قايسى سىياسى پارتىيەلەرگە بايانات|
圣战合法性|Jihad legitimacy
jihad liksiyesi|
جىھاد لىكسىيەسى|
4 yingi sin lintisi|
sowghat|
تىررورلۇق سىن لىنتىسى|
islam awazi|
islam partiyesi|
texwikat merkizi|
muminlerning sayahiti|
eskiri tez yollanmiliri|
kixlik hokok|
islem ewezi|
islem partiyisi|
tashwiqat marqizi,teshwikat|
askiri tiz yollanmiliri|
jennet axiqliri|
tvrkistan|
tvrkstan|
tvrkestan|
as-ansar|
youluchi|
落马高官|Officials sacked
军中老虎|Tiger Army
买官卖官|Buying and selling
30亿工程|3 billion project
创鸿集团|Chuanghong Group
黄鸿明|Huang Hongming
后勤部政委|Logistics political commissar
行贿买官|Buying and bribery
纯金毛主席|Chairman Mao gold
组装shou枪|Shou gun assembly
江家邦|Jiang Jiabang
江家帮|Jiang's home to help
自制s枪|S homemade gun
江择珉|Optional Min Jiang
远华走私案|Yuanhua smuggling
法伦功|Falun Gong
宋组英|Song group English
海政文工团|HAIZHENG Backstage
刘 源|Liu Yuan
郭 伯 雄|Guo Xiong Bo
徐 才 厚|Xu
梁 光 烈|Intense beam of light
钟 绍 军|Zhong Shao Jun
郎 咸 平|Ham Lang Ping
刘 乐 飞|Liu Yue Fei
谷 俊 山|Gu Jun Shan
宋 祖 英|Song Zu Ying
谷开来|Gu
习 近 平|Xi Jinping
邓 小 平|Deng Xiaoping
丽媛国母|Liyuan mother country
万 庆 良|Wanqingliang
吾斯曼·巴图尔|I Klinsmann · Batoul
卡得尔·牙甫泉|Card was Carl teeth Fu Quan
八的平方|Eight square
八平方|Eight square
4的立方|Cube 4
四的立方|Four cubic
8的二次方|Quadratic 8
bajiu|
捌9|Ba 9
八玖|Eight Nine
捌九|Eight nine
ba玖|Nine ba
捌jiu|Ba jiu
8jiu|
信徒之旅|Believers Tour
hijirat|
觉行之路|Feel the line of the road
hz上海|hz Shanghai
禅风|Zen
觉学讲堂|Sleep school auditorium
华藏全息医学|Chinese Tibetan medicine Holographic
聚心堂|Poly Coeur
觉行小窗|Feel OK small window
四海同心|Universal Care
心的世界|Heart of the World
辰华集团|Chen Hua Group
企业联合会|Business Association
玄熙集团|Hyun Hee Group
觉学文化|Sleep learning culture
吴泽衡|Wu Zeheng
吴泽恒|Wu Zeheng
行武禅师|OK Wu Jackson
释行武|Wu release row
号觉皇|No sleep Wong
华藏|China Tibet
曹洞宗的衣钵|Cao's mantle
《生命的思索》|"Life's thinking."
《论心》|"On the Heart"
华藏法露|Lu Hua Tibetan law
佛法与华藏|Tibetan Buddhism with China
《禅钟》|"Zen bell"
两善|Two good
公民互爱|Citizens mutual love
全息医学|Holographic Medicine
年轻的总监坛|Young director altar
禅藏千古|Tibetan Buddhist ages
弘熙御膳|Hiroshi Imperial
企业家联谊会|Entrepreneurs Association
《生命的本质》|"The essence of life."
宗脉世系表|Veins were genealogical table
《宗门品》|"Munekado goods"
《生活禅》|"Life of Zen"
《社会契约论》|"Social Contract"
御和正元|Yu and positive element
灵鹫之音|Tamawashi Voice
辟谷手册|BiGu manual
hujum|
zarba|
zerbe|
yigilish|
türkista|
oyan uygur|
oygan  mslmam|
dolkun aysa|
rabiya|
rabiye|
mehesum|
taxir·yudashif|
abdullah mensur|
özbékistan islam herkiti|
turkisitan silam erket|
turkisitan islam party|
oost-turkestan|
uyghurhotline|
uygurie|
uyghurcanadian|
uyghuramerican|
gokbayrak|
uygurcongress|
hettay|
kapur|
qong loban|
hawa bulutluk|
kamira|
yahxi nersiler|
palanqi yerde toy bar|
soda yahxi|
dohtur|
doxtur|
dawalinix|
yukumluk zukam|
balnista yetish|
bazar baxkurux|
xipahana|
dohturhana|
doxturxana|
huner|
tehnika|
awanqa|
turba|
yagak|
guruq|
qumul qucuni|
yagyu|
nexput|
sewze|
piyaz|
qamgur|
hitai|
hittay|
kafir|
saqchi|
namayix|
namayish|
znay_nashih|
yig'laman_onajon|
xolid_ibn_valid|
soxta_buxoriyga|
sahoba_bol|
robbim_rozi_bulsin|
ravoha_fidoiylik|
ota-ona_qarz|
moghul_tatar|
madrasaga|
juma_|
jang_qilar|
va_harakat|
va_sunnat|
mujohid|
uygurcha|
andalus|
ali1.|
abdulloh|
murojaat|
qurbon_hayit|
ketsa_ketsin|
_shukr|
muslimalar|
yolimiz_davom|
yetkazishda|
isroil|
jihodda|
munofiqlar_gumoni|
nematlarni_eslash|
birlik_vojibotimiz|
kiyomat_haqida|
alloh_rozzoq|
marazlar|
muhojirlar|
baqara_surasi|
shkay_jangiga|
jihodiga|
ajrashi|
asr_surasi|
mustahkam|
istiqomat|
sangarda_suhbat|
saqlanglar|
savol_javob|
taqvo_qilish|
mumtahana|
alloh_bergan|
manhajimiz|
abdulaziz|
dushmandan|
vafo_qilganlar|
inqilobchilarmiz|
charchab_qolmaylik|
sahobalar_izidan|
qachon_nusrat_keladi|
himoyasidamiz|
niso-102-oyat|
isroil_siyosati|
ilm_darslar|
tushib_qolish|
anjuman_1429|
ahdlar|
amr_ibn_os|
ochiq_dushman|
ayollarga|
murojaatnoma|
qurayza_gazvalari|
afgoniston_shimoliga|
mujohidlarga|
ummat_vazifalari|
ibodat_lazzati|
vafo_qilinglar|
ketayotganlarga|
jihodning|
ixlos_shartlari|
xiyonatsiz_jihod|
talimgohda|
muhammad ali|
ichki_inqilob|
hind_ghazvasi|
bandalik_maqomi|
ahd_va_bayat|
shahid rafiq|
ilm_va_amal|
amirning_haqq|
abu abdulloh|
jamoat|
muhojirlik|
niyat_buzilishi|
jamoat haqida1|
buyuk_tijorat|
tahoviy_aqidasi|
charchash|
shahid abu|
qoxun makkiga|
makk fathisi|
mui ta uruxi|
hudaybiya umrisining|
madiniga qaytix|
bilan safiya|
keyinki paliyat|
padixahlarga|
sulhisi|
qaplangan bohtan|
harikat|
qurayza|
ahzab uruxi|
nazir uruxi|
madinida|
xahidlarni|
rasulullahni|
ayallar|
koxuni ohud|
ohod uruxi|
gazziti|
hazziti|
badridin keyinki|
alqiliri|
olganlar|
maglubiyat|
badri uruxi|
yamgur|
badri qong uruxi|
qanlik tokunux|
yahudilar|
jamiat|
rasulullaning|
kantida|
hijriti|
iblisning|
qurayxlardiki|
ansarlar zarba|
aqaba bay'iti|
baytul muqaddas|
yasrablik|
kengaytix|
makka sirtida|
sabri subatlik|
kaygu-alam|
bilan ahirqi|
jilgisidiki|
rasululla sohbiti|
musulman boluxi|
xirin bulak|
shirin bulaq|
yezilghan_sozler|
qarajul|
xati-risi|
allah yolida|
herikiti|
jilbabning|
jumhuriyet|
aldinqi sépi|
milletchi|
chüshenchiler|
jihddining|
démokratikpartiyisi|
jihadiy|
hijiret|
jehad|
新疆东突|East Turkistan in Xinjiang
东突暴力|East Turkistan violence
东突恐怖|East Turkistan terrorist
塔利班恐怖|Taliban terror
塔利班基地|Taliban base
塔利班武装|Taliban
塔利班总部|Taliban headquarters
基地组织|Al-Qaeda
巴格达迪|Baghdadi
yamgur yagmak|
hawa rayi yahxiamas|
nan apirip barmak|
tawuj|
kiqik xirkat|
qong xirkat|
naway lia kiliwat idu|
kalam|
tomur|
baxlik|
qogla|
hojayin|
agrip kalmak|
kisal yinik|
kisal egir|
su quxup kat|
dohturdin qigmak|
dohturhanida|
aelila|
kizil|
maktapta|
boran|
xamal qikidu|
kiqik mal|
qog mal|
daptar|
auss0vjv1|
douyutv|
百度战旗|Baidu banners
战旗tv|Banners tv
zhanqitv|
斗鱼tv|Betta tv
百度斗鱼|Baidu betta
百度douyu|Baidu douyu
战旗直播|Battle Flag Live
中学生罢课|School students strike
大学生罢课|Students go on strike
不反对通知书|Notice of No Objection
去饮活动|Go drink events
遮打道|Chater Road
陈健民|Chan Kin Man
朱耀明|CHU Yiu-ming
游击战行动计划|Guerrilla Action Plan
占中分子|Accounted for the molecules
佔中|Accounted for in
占领中环|Occupy Central
特首辦公室|Chief Executive's Office
金鐘特首|Admiralty Chief Executive
香港民主|Hong Kong democracy
民主政制|Democracy
公民黨|Civic Party
真普选联|True Union election
真普联|True Cape
佔中投票|Accounting for vote
七一佔领|Seventy-one occupation
學聯|ACSF
學民思潮|Scholarism
爱护香港力量|Love Hong Kong power
香港學生會|Hong Kong students
陳日君|Zen
陳方安生|Mrs Chan
鐘庭耀|Robert Chung
美駐香港領事館|US Consulate in Hong Kong
香港大學|University of Hong Kong
香港獨立|Hong Kong Independent
専上聯盟|Graduate league
真普選聯盟|Alliance for True Democracy
公明黨|Komeito
白皮書|White paper
香港民主黨|Hong Kong Democratic Party
佔領中環|Occupy Central
七一遊行|July protests
和平佔中|Accounted for in the peace
香港学生会|Hong Kong students
陈日君|Zen
popvote|
陈方安生|Mrs Chan
钟庭耀|Robert Chung
美驻香港领事馆|US Consulate in Hong Kong
香港大学|University of Hong Kong
香港独立|Hong Kong Independent
专上联盟|Tertiary Alliance
真普选联盟|Alliance for True Democracy
公民党|Civic Party
香港民主党|Hong Kong Democratic Party
七一游行|July protests
和平占中|Accounted for in the peace
港人自治|Hong Kong autonomy
港人治港|Hong Kong people ruling Hong Kong
佔 中|Accounted for in
橡胶子弹|Rubber bullets
催泪弹|Tear bomb
﻿和平占中|Accounted for in the peace
血腥报复|Bloody revenge
黎凡特|Levant
招募成员视频|Recruitment video
展示战利品|Show trophy
东突厥|East Turkestan
亚洲之钥|Asia key
为主道奋斗|The main road of struggle
胜利阵线联合|Joint Front for Victory
东突厥圣战|East Turkestan jihad
摩苏尔|Mosul
黄之峰|Huang Feng
灭罪热线|Crime Stoppers
金鐘|Admiralty
駐港|Hong Kong
逮捕民眾|Arrest people
罷教|Teacher's strike
罷課|Student's strike
罷市|Strike
罷工|Strike
催淚彈|Tear bomb
蘇永康批警|William granted police
戴耀庭|Daiyao Ting
戴耀廷|Daiyao Ting
胡椒喷雾|Pepper Spray
胡椒噴霧|Pepper Spray
wradio电台|Wradio Radio
wradio全球|Wradio global
xam we|
peziliti|
demexikning|
tuba lilghuraba|
kurban hitlik|
keni ummet erkekliri|
ibretlik_kisile|
15-san-tor|
请请寻找天堂|Please look for paradise
迷幻药|Ecstasy
迷情水|Sensation water
催情水|Aphrodisiac water
催情液|Liquid aphrodisiac
女优种子|Actress seed
av天堂网|av Paradise Network
奇幻之国|State fantasy
日本撸多宝|Japan line and Dubbo
yeye撸在线影院|yeye line and online cinema
撸管网|Line and pipe network
第四色空婷婷|The fourth color space Tingting
桃花色影院|Peach color cinema
淫人谷|Kinky people valley
人妻乱伦|Wife incest
私色房|Private room color
第四色播播|The fourth color broadcast sowing
依依情色网|Yiyi Erotic Network
撸飘飘影院|Line and fluttering theater
快活林性息论坛|Foxwoods sexual interest forums
我想爱爱网|I want to love love net
老色哥网|Laosegewang
美国十次啦|US ten friends
色五月|Color May
撸白金|Line and Platinum
爱色网|Love the color network
撸撸射|Line and line and shoot
叉叉叉综合网|Skewer fork IRIN
酒色网|Debauchery Network
色播网|Color broadcast network
色尼玛网|Nima network color
性吧网电|Of it net electricity
性吧之声|The sound of it
天天色综合网|Every color IRIN
来吧综合网|Come IRIN
苍井空伦理片|Aoi ethics film
爱妃网|Aifei Network
深爱激情网|Love passion net
草柳社区|Grass Willow Community
咪咪影院|Mimi theater
淫人阁|Court kinky people
插插插综合网|Plug plug plug IRIN
夜来香社区|Tuberose community
仙童下地狱|Fairchild hell
妈妈的乱欲故事|For the story of her mother's chaos
少女之心|Girl's Heart
色中色论坛|Color in color Forum
天龙八部淫传|Dragon kinky Biography
淫妻俱乐部|Kinky wife club
成人电子书|Adult eBook
母子乱伦|Mother and son incest
色中色影院|Color in the color of the theater
激情视频聊天室|Passion video chat room
金麟岂是池中物|Jinlin How can it abounds
江湖淫娘传|Rivers and lakes kinky motherfucker pass
小姐威客网|Miss Witkey Network
淫淫网|Yin Yin Network
国产a片下载|A homemade movie download
无码成人影院|Uncensored adult theater
午夜成人电影|Midnight adult movies
亚洲色站|Asian color station
三级片地址|Three chip address
怡红电影网|Yihong Movie Network
91电影网|91 Movie Network
聚色网|Poly color screen
色狼集中营|Satyr camps
狼客娱乐网|Wolf passenger entertainment network
楼凤性息|Phoenix House of interest
学生鸡|Students Chicken
援交妹|Compensated dating girl
全国性息大全|Daquan national interest
援交会所|Compensated dating club
伊人电影网|Iraqis Movie Network
丝袜恋足会所|Pantyhose foot fetish club
楼凤信息|Phoenix House Information
av网址|AV Website
丐帮情色论坛|Beggars Erotic Forum
av种子|AV seed
左旋麻黃素|L-ephedrine
左旋麻黄素|L-ephedrine
左轮手狗|Revolver hand dog
尊龙国际|Prestige International
走地皇|Go to Wong
总统娱乐城|President Casino
自制烟花|Homemade fireworks
自制手枪|Homemade pistol
自制k粉教程|Homemade K powder Tutorials
追风弓弩|Herd crossbow
状元娱乐城|Champion Casino
专业办证公司|Professional Accreditation company
重亚硒酸钠|Heavy selenite
重铬酸钠|Sodium dichromate
中握秃鹰|Vultures in the grip
中华狩猎网|China Hunting Network
中华狩猎论坛|China Hunting Forum
中华打猎论坛|China Hunting Forum
中国汽枪网|China QiQiang network
中国弩弓网|Chinese crossbow Network
中国名刀网|China Mito Network
中国猎枪网|China shotgun Network
中国刀网|Chinese foil
中国刀剑网|China knife jianwang
智尊国际|Venus International
植物冰|Ice plant
蜘蛛刀|Spider knife
芝加哥娱乐城|Chicago Casino
证件制作网|Document production network
正规真票|Regular real votes
真实民办学历|Real private education
真人棋牌|Live Chess
真人二八杠|Live Mahjong
真钱轮盘赌博|Real money roulette
真钱百家乐|Real Money Baccarat
赭曲毒素|Ochratoxin
折叠手弓弩|Folding hand crossbow
折叠气枪|Folding airgun
赵氏弓弩|Zhao crossbow
长治筋|Changzhi tendons
战术折刀|Tactical knife
战术军刀|Tactical saber
战术军刺|Tactical Shanker
战术狗腿刀|Dogleg tactical knife
战神国际娱乐城|Ares International Casino
战神弓弩|Ares crossbow
宅急送数据|Home delivery data
炸弹diy|DIY bomb
在线现金扑克|Online cash poker
云南情蛊|Yunnan love insanity
云鼎娱乐城|Yun Ding Casino
云顶国际娱乐城|Genting International Casino
悦榕庄娱乐城|Banyan Tree Casino
月亮城娱乐城|Moon City Casino
远华国际娱乐城|Yuanhua International Casino
原砷酸|Original arsenate
御匾会娱乐城|Casino Royal plaque will
有偿献|Paid offer
有偿提供|Paid to provide
有偿售|Paid for sale
有偿卖|Paid sell
有偿捐赠|Paid donation
有偿捐献|Paid donation
犹太人娱乐城|Jews Casino
优德w88|Excellent German W88
优博娱乐城|Yubo Casino
永隆国际娱乐城|Wing Lung International Casino
永利娱乐城|Wynn Casino
永利会娱乐城|Wynn Casino will
永利高娱乐城|High Wynn Casino
永利高现金网|Wynn high net cash
永利高|Wynn high
永辉娱乐城|Yonghui Casino
永辉国际娱乐城|Yonghui International Casino
硬币模具|Coin dies
赢乐国际|Le Win International
盈胜国际|Ying Sheng International
盈丰国际娱乐城|Goodrich International Casino
盈得利娱乐城|Surplus profit Casino
盈博娱乐城|Ying Bo Casino
盈槟娱乐城|Penang surplus Casino
罂粟碱|Papaverine
英语等级证|English grade certificate
英皇娱乐城|King's Casino
英国骚本|The British show
英国b50|British b50
银氰化钾|Silver cyanide
银联国际娱乐城|CUP International Casino
银河娱乐城|Galaxy Casino
银行卡生成器|Bank Card Builder
银行卡克隆设备|Bank Kake Long Equipment
银行卡解码器|Bank card decoders
银行卡复制器|Bank Card Copy
易胜博博彩|Yi Sheng Cai Bobo
异黄樟素|Isosafrole
异丁腈|Isobutyronitrile
亿博娱乐城|Bo billion Entertainment City
乙酸亚铊|Asian thallium acetate
乙酸汞|Mercuric acetate
乙酸苯汞|Phenyl mercuric acetate
乙硼烷|Diborane
乙基氰|Ethyl cyanide
壹贰博|One II Bo
一氧化二氟|An oxide-difluoro
一码中特|A 码中特
一氯乙醛|A chlorine acetaldehyde
一氯醋酸|Monochloroacetic acid
一代国际娱乐城|Generation International Casino
一比一枪模|A ratio shot mode
液体炸药比例|The proportion of liquid explosives
野战砍刀|Field Chopper
遥控炸弹|Remote-controlled bomb
摇头丸制作方法|Ecstasy production methods
摇头丸配方|Ecstasy Recipe
姚记娱乐城|Yao Kee Casino
氧化亚铊|Thallium oxide Asia
氧化铊|Thallium oxide
阳江刀剑网|Yangjiang knife jianwang
眼镜蛇弩|Cobra crossbow
盐酸曲马多|Tramadol hydrochloride
盐酸麻黄素|Ephedrine hydrochloride
盐酸麻黄碱|Ephedrine hydrochloride
亚洲打猎论坛|Asian Hunting Forum
亚硝酸乙酯|Ethyl nitrite
亚太国际娱乐城|Asia-Pacific International Casino
亚砷酸钠|Sodium arsenite
亚砷酸钾|Potassium arsenite
亚甲基二氧苯基|Methylenedioxyphenyl
雅典娱乐城|Athens Casino
溴氰菊酯|Deltamethrin
溴化汞|Mercury bromide
雄鹰svd|Eagle SVD
兄弟娱乐城|Brothers Casino
兄弟打猎论坛|Brothers Hunting Forum
星球赌场|Casino Planet
星期8娱乐城|Week 8 Casino
星际娱乐城|StarCraft Casino
星河娱乐城|Galaxy Casino
星河网络娱乐城|Galaxy Internet Casino
信用卡客户资料|Credit card customer data
信用卡复制器|Credit card replicator
新西兰娱乐城|New Zealand Casino
新世盈娱乐城|Pliocene surplus Casino
新世纪娱乐城|New Century Casino
新时代娱乐城|New Age Entertainment City
新全讯网|The new full-News Network
新千秋狩猎论坛|New Chiaki Hunting Forum
新葡京娱乐城|Grand Lisboa Casino
新利娱乐城|Xinli Casino
新金沙娱乐城|The new Sands Casino
新加坡娱乐场|Singapore Casino
新濠天地娱乐城|City of Dreams Casino
新濠峰娱乐城|Melco Peak Casino
新濠博亚娱乐城|Melco Crown Entertainment City
新概念娱乐城|The new concept Casino
新东泰娱乐城|New Dongtai Casino
新博彩通|New gaming through
新宝娱乐城|Noble Casino
新澳门赌球网|New Macau gambling network
新澳博娱乐城|New SJM Casino
新奥博娱乐城|XinAoMDT Casino
新2现金网|2 net new cash
小六改火|Six fire change
小飞狼弩|Flying Wolf crossbow
硝酸汞|Mercuric nitrate
硝酸高汞|High mercury nitrate
硝酸胺炸药|Ammonium nitrate explosives
硝甲西泮|Nimetazepam
硝化甘油|Nitroglycerine
硝胺炸药|Nitramine explosives
硝铵炸药|Explosive
逍遥坊娱乐城|Happy Square Casino
香料精灵|Spice Elf
香格里拉娱乐城|Shangri-La Entertainment City
香港ghb粉|Hong Kong GHB powder
香港ghb|Hong Kong ghb
相思红娘粉|Acacia powder Matchmaker
线上21点|Online 21:00
现金棋牌游戏|Cash chess game
现金龙虎斗|Illustrating cash
喜力国际娱乐城|Heineken International Casino
喜达娱乐城|Starwood Casino
洗码返水|Wash water back yard
锡锋汽枪|Tin Feng QiQiang
锡锋牌气枪|Tin Feng brand airgun
锡锋牌b8|Tin Feng brand B8
烯丙胺|Allylamine
希尔顿娱乐城|Hilton Casino
吸毒冰壶|Drug Curling
西力生|West Lisheng
西点军品网|West Point Military Network
西布曲明|Sibutramine
西班牙gamo|Spain gamo
物流客户资料|Logistics and customer information
物流客户数据|Logistics and customer data
物流成单数据|Into a single data stream
武警作战服|Armed combat uniforms
五星娱乐城|Star Casino
五四式手枪|Fourth-style pistol
五四式手狗|Fourth-style hand-dog
五氯酚钠|Sodium pentachlorophenol
五氯苯酚|Pentachlorophenol
五湖四海娱乐城|Wuhusihai Casino
五狐狩猎网|Five fox hunting Network
无水肼|Anhydrous hydrazine
无声猫|Silent Cat
乌头碱|Aconitine
文凭代办网|Diploma agency network
温切斯特气枪|Winchester airgun
伪麻黄素|Pseudoephedrine
伪麻黄碱|Pseudoephedrine
伟易博娱乐城|Wei Yi Bo Casino
伟德亚洲|Weide Asia
维多利亚娱乐城|Victoria Casino
微型冲锋枪|Micro submachine gun
微声手枪|Silenced pistol
威斯汀娱乐城|Westin Casino
威尼斯人娱乐城|Venetian Casino
威龙国际娱乐城|Veyron International Casino
威龙国际网|Veyron international network
威廉希尔娱乐城|William Hill Casino
网络真钱赌博|Internet gambling for real money
王子娱乐城|Prince Casino
万人迷娱乐城|Stunner Casino
万豪娱乐城|Marriott Casino
万国娱乐城|IWC Casino
万达国际娱乐城|Wanda International Casino
万宝路娱乐城|Marlboro Casino
瓦斯手枪|Gas Pistol
瓦尔特cp99|Walther cp99
脱氧麻黄碱|Methamphetamine
土制手榴弹|Homemade grenades
土制手雷|Homemade grenades
土制燃烧弹|Homemade incendiary
土制猎枪|Homemade shotgun
土制火药|Homemade gunpowder
土炸药配方|Soil explosive formulation
土炸弹制作流程|Earth bomb-making process
土豪娱乐城|Tyrant Casino
秃鹰组装教程|Vulture assembly Tutorials
秃鹰图纸|Vulture drawings
秃鹰套件|Vulture Kit
秃鹰狩猎论坛|Vulture Hunting Forum
秃鹰枪|Vulture gun
秃鹰汽长狗|Vulture steam long dog
秃鹰汽枪网|Vulture QiQiang Network
秃鹰气枪|Vulture airgun
秃鹰气瓶|Vulture cylinders
秃鹰配件|Vulture accessories
秃鹰论坛|Vulture Forum
秃鹰狗|Vulture dog
秃鹰扳机|Vulture trigger
骰宝|Sic Bo
投注娱乐|Entertainment Betting
同花顺娱乐城|Flush Casino
铁杆娱乐城|Irons Casino
铁杆会娱乐城|Irons would Casino
天上人间娱乐城|Heaven Casino
天然可卡因|Natural cocaine
天猫娱乐城|Lynx Entertainment City
天空娱乐城|Sky Casino
天将国际娱乐|Day international entertainment
天将国际|Day international
天地无限娱乐城|Tiandiwuxian Casino
天成国际娱乐城|Tiancheng International Casino
天朝狩猎论坛|Celestial Hunting Forum
天博国际娱乐城|Bo-day International Casino
替马西泮|Temazepam
特码诗|Special code poem
特警作战服|SWAT combat uniforms
特级运动长弹|Extra long bomb campaign
羰基氟|Carbonyl fluoride
碳酸亚铊|Thallium carbonate
碳酸铊|Thallium carbonate
泰姬玛哈娱乐城|Taj Mahal Casino
太阳城百家乐|Sun City Baccarat
太平洋娱乐城|Pacific Casino
太恩炸药|Too Well explosives
台湾秃鹰|Taiwan Vulture
台秃|Taiwan bald
索罗门娱乐城|Solomon Casino
索雷尔娱乐城|Sorrell Casino
塑料炸弹|Plastic Bomb
塑胶炸药|Plastic Explosives
速博娱乐城|Subscription Casino
送码图|Send code map
送码诗|Send code poem
四氧化锇|Osmium tetroxide
四氯硫代碳酰|Tetrachloro carbothiohydrazide
顺丰面单数据|SF side single data
顺丰快递数据|SF Express Data
水晶宫娱乐城|Crystal Palace Casino
水晶城娱乐城|Crystal City Casino
水胶炸药|Water gel explosive
双子星娱乐城|Gemini Casino
双喜赌场|Double Happiness Casino
双筒猎枪|Shotgun
双刃尖刀|Double-edged knife
双管猎枪|Double-barreled shotgun
狩猎弩|Crossbow Hunting
首席娱乐城|Chief Casino
手枪见面交易|Pistol meet transaction
手拉鸡|Hand chicken
手拉狗|Hand Dog
手狗配件|Hand dog accessories
收藏品数据|Data Collection
收藏品客户资料|Collection of customer data
世界名刀网|Network World Mito
世纪打猎论坛|Century hunting forum
士的宁|Strychnine
矢车菊甙|Cyanidin glycosides
时时博娱乐城|Bo always Casino
十字弓弩|Cross crossbow
十六浦娱乐城|Ponte 16 Casino
狮威娱乐城|Skol Casino
盛大娱乐城|Grand Casino
圣淘沙娱乐城|Sentosa Casino
升汞|Mercuric chloride
砷化氢|Arsine
申博娱乐城|Shenbo Casino
申博国际|Shenbo International
上海工字汽狗|Shanghai Steam word dog
上海工字气枪|Shanghai word airgun
上海工字气狗|Shanghai word gas dog
上海工字牌气狗|Shanghai Gas Jeans brand dog
沙龙娱乐城|Salon Casino
沙菲片|Shafi piece
沙巴娱乐城|Sabah Casino
森林之狼弓弩|Wolf Forest crossbow
骚本套件|Sao This kit
骚本气枪|The air gun show
三优娱乐|Three excellent entertainment
三氧化二砷|Arsenic trioxide
三硝基甲苯|Trinitrotoluene
三硝基苯酚|Trinitrophenol
三氯硫氯甲烷|Triclosan sulfur chloride
三氯化砷|Arsenic trichloride
三利达追月|Lida chasing three months
三利达官网|Three LEADER official website
三利达弓弩|Three LEADER crossbow
三利达大黑鹰|Three big Blackhawk Leader
三利达|Three LEADER
三棱跳刀|Tri-dagger
三棱军刀|Tri-saber
三棱军刺|Tri Shanker
三棱尖刀|Tri knife
三棱尖刺|Triangular spikes
三棱刮刀|Tri-scraper
三棱刺刀|Triangular bayonet
三棱刺|Triangular spines
三角牌气枪|Triangle airgun
三箭汽枪|Three arrows QiQiang
三箭汽狗|Three arrows steam Dogs
三箭气枪网|Three arrows airgun Network
三箭气枪|Three arrows airgun
三箭气狗|Three arrows gas dog
三箭改|Three arrows to change
三箭b5-2|Three arrows B5-2
三箭b5|Three arrows b5
三健弓弩|Three health crossbow
三国真人娱乐城|Three Live Casino
三氟化硼|Boron trifluoride
赛丸丁|Race pill Ding
瑞士娱乐城|Swiss Casino
瑞丰国际|Ruifeng International
瑞典fx|Sweden fx
瑞博娱乐城|Rainbow Casino
乳腈|Lactonitrile
乳化炸药|Emulsion explosives
人造芥子油|Artificial mustard oil
热兵器|Thermal Weapon
燃烧弹|Incendiary
全球通用户资料|GSM User Profile
全氟异丁烯|Perfluoroisobutylene
全氟丙酮|Perfluoroacetone
去氧麻黄素|Methamphetamine
去甲伪麻黄碱|Cathine
去甲麻黄素|Norephedrine
去甲麻黄碱|Norephedrine
去澳门娱乐城|To Macau Casino
氰甲汞胍|A mercury cyanide guanidine
氰化银钾|Silver potassium cyanide
氰化金钾|Potassium gold cyanide
氰化钾|Potassium cyanide
氰化汞|Mercuric cyanide
氰化钙|Calcium cyanide
氰化碘|Iodine cyanide
氰胍甲汞|A mercury cyanide guanidine
千亿娱乐|One hundred billion entertainment
千秋狩猎论坛|Chiaki Hunting Forum
企业老板资料|Business owners information
棋牌真钱游戏|Chess game for real money
期货客户资源|Futures client resources
期货客户资料|Futures Customer Information
期货客户名单|Futures client list
七七式手枪|Seventy-seven pistol
七匹狼娱乐城|Seven wolves Casino
七孔狗腿刀|Seven holes dogleg knife
普通增值税发票|Ordinary VAT invoice
普斯普剂|普斯普 agent
普拉西泮|Prazepam
扑克王娱乐城|Poker King Casino
偏压砷酸钠|Bias arsenite
硼烷|Borane
庞博娱乐城|Pombo Casino
女神娱乐城|Goddess Casino
女神国际|Goddess International
弩弓制作图纸|Crossbow making drawings
弩弓官网|Crossbow official website
纽约国际娱乐城|New York International Casino
尼泊尔弯刀|Nepal machete
尼泊尔狗腿刀|Nepal dogleg knife
内裤炸弹|Underwear bomb
木星娱乐城|Jupiter Casino
牡丹国际娱乐城|Peony International Casino
墨尔本娱乐城|Melbourne Casino
莫洛托夫鸡尾酒|Molotov Cocktail
莫达非尼|Modafinil
摩斯国际娱乐城|Holmes International Casino
摩纳哥娱乐城|Monaco Casino
摩卡线上娱乐|Mocha online entertainment
明珠娱乐城|Pearl Casino
明珠百家乐园|Pearl one hundred Paradise
明升娱乐城|Mingsheng Casino
名仕娱乐城|Malibu Casino
灭害威|Miehai Granville
缅古制作技术|Myanmar ancient production technology
缅古制作方法|Myanmar ancient production methods
缅古配方|Myanmar ancient recipe
米其林娱乐城|Michelin Casino
米尔军刀网|Mill Sabres net
蒙特卡罗娱乐城|Monte Carlo Casino
美秃图纸|US bald drawings
美秃套件|Bald beauty kit
美式轮盘|American Roulette
美沙酮|Methadone
美高梅娱乐城|MGM Casino
美高梅赌场|MGM Casino
唛可奈因|Mark Chennai due
麦角乙二胺|Ergot ethylenediamine
麦角酸提炼技术|Lysergic acid extraction technology
麦角酸二乙胺|Lysergic acid amine
麦角胺|Ergotamine
迈巴赫娱乐城|Maybach Casino
马钱子碱|Strychnine
马拉硫磷|Malathion
马可波罗娱乐城|Marco Polo Casino
马德里娱乐城|Madrid Casino
麻醉枪网|Tranquilizer gun Network
麻醉枪弩|Tranquilizer gun crossbow
麻醉弩枪|Anesthesia crossbow gun
麻醉弩箭|Anesthesia bolt
麻醉弩|Anesthesia crossbow
麻醉箭弩|Anesthesia crossbow arrow
麻醉弓弩|Anesthesia crossbow
麻黃素|Ephedrine
麻黄素羟亚胺|Ephedrine hydroxy imine
麻黄浸膏|Ephedra Extract
麻黄碱|Ephedrine
麻果配方|Ma fruit recipes
麻果壶|Ma fruit pot
麻古制作技术|Ma old production technology
麻古制作方法|Ma old production methods
麻古配方|Ma old recipe
麻古壶|Ma old pot
氯乙酸|TCA
氯硝西泮|Clonazepam
氯硫酸|Chlorine sulfuric acid
氯甲酸甲酯|Methylchloroformate
氯磺酸|Chlorosulfonic acid
氯化银钾|Silver chloride and potassium
氯化亚砷|Chlorinated arsenite
氯化硫酰甲烷|Thionyl chloride, methane
氯化硫酸|Chloride, sulfuric acid
氯化汞|Mercuric chloride
氯胺酮制作配方|Ketamine Recipes
氯胺酮制作方法|Ketamine production methods
氯氨酮|Ketamine
绿瓦管|Lvwa tube
绿藜芦生物碱|Green alkaloids
落榜考生名单|Candidates get the job list
洛克娱乐城|Rock Casino
洛克kj900|Locke KJ900
罗马娱乐城|Rome Casino
罗浮宫娱乐|Louvre Entertainment
罗顿国际|Lawton International
路易十三娱乐城|Louis XIII Casino
卢克索娱乐城|Luxor Casino
六氢大麻酚|Hexahydro THC
六合玄机|Kuni mystery
六合彩内参|Mark Six internal reference
六氟丙酮|Hexafluoroacetone
硫酸亚铊|Thallium  sulfate
硫酸铊|Thallium sulfate
硫氰化汞|Mercury thiocyanate
溜冰壶|Skating pot
邻氨基苯甲酸|Anthranilate
猎人汽狗网|Dog Hunters Steam Network
猎枪销售网|Shotgun sales network
猎枪铅弹|Shotgun pellet
猎枪配件|Shotgun Accessories
猎枪弹|Shotgun shells
猎狗铅弹|Hounds lead bullets
猎豹弓弩|Cheetah crossbow
联众娱乐城|Thousands Casino
联通客户资料|Unicom customer data
联盟狩猎论坛|Alliance Hunting Forum
利赢娱乐城|Lee won the Casino
利来国际娱乐城|LeRoy International Casino
利澳娱乐城|Rio Casino
利奥娱乐城|Leo Casino
励骏会娱乐城|Lai Chun would Casino
丽星邮轮娱乐城|Star Cruises Casino
立博国际|Ladbrokes International
力月西片|May the force Western films
力斯曼弩|Mann force crossbow
里兹俱乐部|Leeds club
礼花弹|Shells
藜芦碱|Veratridine
黎城辣面|Licheng spicy noodles
雷鸣顿|Dayton thunder
雷鸣登汽枪|Gordon thunderous steam gun
雷鸣登猎枪|Gordon thunderous shotgun
雷明顿猎枪|Remington shotgun
雷汞|Leigong
乐中乐娱乐城|Music in the music entertainment city
乐九娱乐城|Le nine Casino
乐百家娱乐城|Music one hundred Casino
老妖狩猎论坛|Witch hunting forum
老挝蓝盾娱乐|Laos Blue Shield Entertainment
老人资料|Elderly Data
老人头娱乐城|Old head Casino
老人数据|Elderly Data
老钱庄娱乐|Old banks Entertainment
老年人资料|Elderly Data
老年人信息|Elderly Information
老年人数据|Elderly Data
老板资料|Owner information
老板通讯录|Boss Contacts
老板手机号码|Boss phone number
劳力士娱乐城|Rolex Casino
蓝盾娱乐城|Blue Shield Casino
蓝盾国际娱乐城|Blue Shield International Casino
廓尔喀弯刀|Gurkha Scimitar
廓尔喀军刀|Gurkha knife
廓尔喀刀|Kukri
快排吹图纸|Drawings row fast blow
快活大赌场|Foxwoods Resort Casino
快递面单资料|Express side single data
快递面单数据|Express side single data
空中城市娱乐城|Air City Casino
空军一号娱乐城|Air Force One Casino
刻章办证公司|Rush engraving company
克拉克娱乐场|Clark Casino
康莱德娱乐城|Conrad Casino
凯旋门娱乐城|Arch Entertainment City
凯斯娱乐城|Case Casino
凯斯线上娱乐网|Case online entertainment network
凯时娱乐城|When Kay Casino
凯撒皇宫娱乐城|Caesar's Palace Casino
凯豪国际娱乐城|Howard International Casino
凯豪国际|Hale International
卡西酮|Methcathinone
卡卡湾娱乐城|Kaka Bay Casino
卡迪拉娱乐城|Cadila Casino
卡巴军刀|Kabbah saber
卡巴刀|Ka-Bar
咖啡碱|Caffeine
军用折叠弩|Military folding crossbow
军用枪支|Military firearms
军用潜水刀|Military diving knife
军用弩箭|Military bolt
军用雷管|Military detonators
军用钢珠弩|Military Ball crossbow
军用刺刀|Military bayonet
军品刺刀|Military bayonet
军官证样本|Military officer sample
军刺枪刺|Shanker bayonet
军车套牌|Military vehicle decks
聚宝盆娱乐城|Cornucopia Casino
巨星娱乐城|Star Casino
巨城娱乐城|Giant City Casino
狙击枪网|Sniper rifle network
狙击步狗|Step sniper dog
旧金山娱乐城|San Francisco Casino
精品弓弩|Boutique crossbow
京城国际娱乐城|Beijing International Casino
进口手狗|Imported hand dog
进口汽枪|Imported air guns
进口气枪网|Net imports of airguns
进口气狗|Dogs imported gas
进口弓弩|Imported crossbow
金字塔娱乐城|Pyramid Casino
金钟汽枪|Admiralty QiQiang
金钟气狗|Admiralty Air Dog
金域娱乐城|Golden Casino
金盈会|Jinying will
金银岛娱乐城|Treasure Island Casino
金属铊|Metal thallium
金属枪模|Gun metal mold
金属仿真枪|Metal imitation guns
金盛国际娱乐城|Jinsheng International Casino
金沙娱乐城|Sands Casino
金沙娱乐场|Sands Casino
金沙赌场|Sands Casino
金融客户资源|Financial customer resources
金融客户资料|Financial customer information
金融客户数据|Financial customer data
金钱豹娱乐城|Leopard Casino
金牌娱乐城|Gold Casino
金牌线上娱乐城|Gold Online Casino
金木棉娱乐城|Golden Casino kapok
金木棉赌场|Golden Casino kapok
金满堂娱乐城|Gold Full Casino
金马娱乐城|Golden Horse Casino
金界娱乐城|NagaWorld
金花娱乐城|Golden Casino
金海岸娱乐城|Gold Coast Casino
金冠娱乐城|Golden Crown Casino
金弓电狗|Gold bow electric dog
金弓m4|Gold bow m4
金都娱乐城|Waldo Casino
金彩国际娱乐城|Jin Caiguo Inter Casino
金博士娱乐城|Dr. King's Casino
金杯娱乐城|Gold Casino
金宝博娱乐城|CASINO Casino
金宝博|CASINO
将军娱乐城|General Casino
江山娱乐城|Empress Casino
健卫步枪|Jian Wei rifle
甲藻毒素|Dinoflagellate toxins
甲氧麻黄酮|Mephedrone
甲硝西泮|A nitrazepam
甲烷磺酰氯|Methanesulfonyl chloride
甲氰菊酯|Fenpropathrin
甲卡西酮|Methcathinone
甲基乙基酮|Methyl ethyl ketone
甲基麻黄素|Methyl ephedrine
甲基肼|Methyl hydrazine
甲基甲卡西酮|Methyl methcathinone
甲基磺酰氯|Methanesulfonyl chloride
甲基磺酰氟|Methyl sulfonyl fluoride
甲基碘|Methyl iodide
甲基丙烯腈|Methacrylonitrile
甲基苯丙胺|Methamphetamine
甲基安非他命|Methamphetamine
甲基安非他明|A methamphetamine
甲磺酰氟|Methanesulfonyl fluoride
甲苯喹唑酮|Toluene quinazolone
嘉年华娱乐城|Carnival Casino
嘉禾娱乐城|Golden Harvest Entertainment City
季戊四醇|Pentaerythritol
火药配方大全|Gunpowder recipe Daquan
汇丰国际娱乐城|HSBC International Casino
回力娱乐城|Warrior Casino
辉煌国际|Brilliant International
黄樟油|Sassafras oil
黄色炸药|TNT
黄曲霉素|Aflatoxin
黄金城娱乐场|Golden City Casino
皇室娱乐城|Royal Casino
皇浦国际娱乐城|Huang Pu International Casino
皇家娱乐城|Royal Casino
皇家金堡娱乐城|Casa Real Casino
皇冠足球网|Crown Football Network
皇冠在线赌场|Crown Casino Online
皇冠娱乐城|Crown Casino
皇冠现金网|Net cash crown
皇冠博彩|Crown Betting
皇都娱乐城|Royal Casino
皇朝娱乐城|Dynasty Casino
环亚娱乐城|Round-Casino
环球娱乐城|Universal Entertainment City
欢乐博娱乐城|Happy Bo Casino
华夏狩猎论坛|China Hunting Forum
华特霸者|Walt Bazhe
华泰娱乐城|Huatai Casino
华盛顿娱乐城|Washington Casino
华人博彩论坛|Chinese Betting Forum
华克国际娱乐城|Hua Keguo Inter Casino
华尔街娱乐城|Wall Street Casino
花山n306|Huashan N306
花青甙|Anthocyanin
户外军品网|Outdoor military network
户外刀具网|Outdoor Network Tool
户撒刀|Husa knife
琥珀胆碱|Succinylcholine
虎牙刀|Eye teeth knife
蝴蝶甩刀|Butterfly flail
蝴蝶刀|Butterfly knife
胡椒醛|Heliotropin
胡椒基甲酮|Piperonyl methanone
鸿运国际娱乐城|Fortune International Casino
鸿利会娱乐城|Hongli would Casino
鸿利国际|Hongli International
红树林娱乐城|Mangrove Casino
红烧兔子大餐|Braised rabbit feast
红降汞|Red drop of mercury
红海葱甙|Red onions glycosides
红宝石娱乐城|Ruby Casino
红9娱乐城|9 Red Casino
恒和国际娱乐城|Constant and International Casino
黑索金|RDX
黑索今|RDX
黑森林弓弩|Black Forest crossbow
黑曼巴弩|Black Mamba crossbow
好刀网|Good foil
豪享博娱乐城|Haoxianglai Bo Casino
豪门国际俱乐部|Noble International Club
酣乐欣|Halcion
海洋之神娱乐城|God of the Sea Casino
海王星娱乐城|Neptune Casino
海南岛娱乐城|Hainan Island Casino
海洛因制作方法|Heroin production methods
海洛因|Heroin
海立方娱乐城|Casino Oceanus
海乐神|Lok God
过氯甲硫醇|Perchloric methyl mercaptan
国外文凭|Foreign diplomas
国恒娱乐|Kwok-hang Entertainment
国产气枪|Domestic air gun
国安证|National Security card
贵族娱乐城|Nobility Casino
硅烷炸弹|Silane bomb
广发娱乐网|GF Entertainment Network
冠军娱乐城|Champion Casino
股民资源|Investors Resources
股民资料网|Investors Information Network
股民资料|Investors information
股民信息|Investors information
股民数据|Investors Data
股民名录|List of shareholders
股民名单|List of shareholders
股民联系方式|Contact investors
股民开户资料|Investors account information
股民开户数据|Shareholders accounts data
股民个人资料|Investors Profile
股民个人信息|Investors Personal Information
股民电话资源|Investors telephony resources
股民电话号码|Shareholders phone number
古可叶|Old can leaf
古柯碱|Cocaine
咕噜壶|Grunt pot
狗腿弯刀|Dogleg machete
狗腿刀|Dogleg knife
狗管|Dogs tube
公海赌船娱乐城|Casino gambling ship on the high seas
工字气枪网|Word airgun network
工字qb|QB word
工业雷管|Detonator
格斗刀|Fighting Knife
戈博刀|Gebo knife
高压汽枪|High pressure steam gun
高压鸟枪|High pressure shotgun
高压警棍|High voltage baton
高压电警棍|High voltage electric batons
高压打鸟枪|High Pressure shotgun
高压步枪|High pressure rifle
高消费人群名录|High consumer groups List
高哌啶|Homopiperidine
高考学生资料|Entrance Student Information
高考学生信息|Entrance Student Information
高考考生资料|College entrance examination information
高官名录|List of officials
高仿证件网|High imitation network credentials
高仿证|High imitation card
高仿学位证|High imitation degree certificate
高仿身份证|High imitation ID
高仿人民币|High imitation yuan
高仿军官证|High imitation military officer
高仿警官证|High imitation Jing Guanzheng
高仿警服|High imitation uniforms
高仿警察证|High imitation police certificate
高仿户口本|High imitation account of this
高尔夫娱乐城|Golf Casino
高点娱乐城|High Point Casino
高爆炸药|High explosives
钢珠汽枪网|Ball QiQiang network
钢珠汽枪|Ball QiQiang
钢珠弩|Ball crossbow
钢珠猎狗|Ball hounds
改装射钉枪|Modified gun
改装发令枪|Modified starting gun
改火套件|Change fire kit
富易堂娱乐城|Fu Yi Tong Casino
富人资料|Rich data
富人信息|Rich information
富人数据|Rich data
富豪数据|Regal Data
福寿膏|Longevity cream
福布斯娱乐城|Forbes Casino
氟乙酸胺|Acid amine fluoride
氟硝西泮|Flunitrazepam
氟醋酸钠|Fluoride, sodium acetate
服刑人员资料|Prisoners information
菲律宾太阳城|Sun City, Philippines
菲彩国际娱乐城|Fei Cai International Casino
放线菌酮|CHX
仿制警服|Imitation uniforms
仿真长狗|Simulation of Long Dog
仿真枪械网|Network simulation firearms
仿真枪网|Imitation guns Network
仿真汽枪|Simulation QiQiang
仿真气枪|Simulation Airsoft
仿真气木仓|Simulation of gas wooden warehouse
仿真气狗|Simulation of gas dog
仿真警服|Simulation uniforms
仿真钢弹枪|Simulation steel gun
仿真电狗|Simulation electric dog
仿真64|Simulation 64
房地产客户资料|Real Estate Customer Information
犯人数据|Prisoner data
反恐弩|Counterterrorism crossbow
番木鳖碱|Strychnine
法人资料|Legal Information
法人数据|Corporate data
法人手机号码|Corporate phone number
法尼林|Fani Lin
发中发娱乐城|Hair Dafa888
发射药|Propellant
二乙基汞|Diethyl mercury
二盐酸盐|Dihydrochloride
二手弩|Used crossbow
二氯化汞|Mercury dichloride
二氯苯胂|Dichlorobenzene arsine
二磷化三锌|Zinc phosphide
二甲基安非他明|Dimethyl amphetamine
二碘化汞|Two mercuric iodide
恩华三唑仑|En Hua triazolam
锇酸酐|Osmium anhydride
峨眉气枪|Emei airgun
峨眉牌汽枪|Emei brand QiQiang
多伦多娱乐城|Toronto casino
赌王娱乐城|Kings Casino
董姐刀剑网|Dong Jian Wang sister knife
东方狩猎论坛|Oriental Hunting Forum
东方皇朝娱乐城|Orient Dynasty Casino
鼎尚国际娱乐城|Noble International Casino
鼎龙国际娱乐城|Donlord International Casino
鼎丰国际娱乐城|Ding Feng International Casino
顶尖娱乐城|Top Casino
丁腈|Nitrile
丁丙诺啡|Buprenorphine
电子炸弹|Electronic bomb
电信用户资料|Telecommunications User Profile
电视购物资源|TV shopping resources
电视购物资料|TV Shopping Information
电视购物数据|TV shopping data
电视购物名录|TV Shopping List
电购资料|Power purchase information
电购面单数据|Power purchase single data plane
电狗网|Electric Dog Network
碘甲烷|Iodomethane
碘化汞|Mercuric iodide
帝王娱乐城|Monarch Casino
帝豪国际娱乐城|Regency International Casino
帝国娱乐城|Empire Casino
地高辛|Digoxin
敌杀磷|Kill the enemy phosphorus
敌恶磷|Evil enemy phosphorus
敌百虫|Trichlorfon
德晋娱乐城|De Jin Casino
德国夜鹰|Germany Nighthawk
德版ppk|German version PPK
导爆索|Detonating cord
刀迷汇|Knife fans Meeting
氮芥气|Mustard gas
弹簧跳刀|Spring jump knife
弹簧刀|Switchblade
单管猎枪|Single-barreled shotgun
代理发票公司|Acting invoice Company
代办发票公司|Agency invoice Company
大中华娱乐城|Greater China Casino
大中华国际赌场|Great China International Casino
大赢家真人娱乐|Winner Live Casino
大玩家娱乐城|Grand Casino Players
大上海娱乐城|Shanghai Grand Casino
大三元娱乐城|Big Three Casino
大三元|Big Three
大三巴娱乐城|Ruins Casino
大漠狩猎论坛|Desert Hunting Forum
大马士革军刀|Damascus saber
大马士革刀|Damascus Knife
大麻烟|Marijuana
大佬娱乐城|Gangster Casino
大口径pcp|Large caliber PCP
大家旺娱乐城|We Wang Casino
大黑鹰弓弩|Large Black Hawk crossbow
大富豪娱乐城|Regal Casino
大丰收娱乐城|Harvest Casino
大发娱乐城|Dafa888
大发娱乐|Dafa888
大都会娱乐城|Metropolitan Entertainment City
打鸟汽枪|Uchitori QiQiang
打鸟气枪|Uchitori airgun
醋酸铊|Thallium acetate
醋酸汞|Mercuric acetate
丛林直刀|Jungle straight knife
丛林开山刀|Jungle machete
磁道内码信息|Track code information within
磁道内码|Tracks within the code
纯缅麻古|Pure hemp ancient Myanmar
传奇娱乐城|Legends Casino
处女星号娱乐城|Virgo Casino
赤壁娱乐城|Chibi Casino
诚信汽枪网|QiQiang network integrity
车主资源|Resource owners
车主信息资料|Owners information
车主名录网|List of network owners
车主名录|List owners
车主保险数据|Owners insurance data
车辆牌照|Vehicle license
朝鲜冰|Korean ice
侧拉式气枪|Side pull airgun
财富娱乐城|Fortune Casino
布加迪娱乐城|Bugatti Casino
不夜城娱乐城|Entertainment city that never sleeps
不凡军品网|Extraordinary military network
不凡军品|Extraordinary military
博赢娱乐城|Bo Win Casino
博伊刀|Boyd knife
博天堂娱乐城|Sportingbet Casino
博马365|Boma 365
博九娱乐场|Bo nine casinos
博九网|Bo nine network
博狗娱乐城|Bodog Casino
博狗娱乐场|Bodog Casino
博狗亚洲|Bodog Asia
博彩通|Betting pass
博彩平台|Gaming Platform
博彩老头|Betting old man
博澳娱乐城|Bo Macau Casino
博e百娱乐城|E one hundred Bo Casino
勃朗宁刀|Browning knife
勃郎宁刀|Browning knife
伯莱塔|Beretta
伯爵娱乐城|Earl Casino
菠菜娱乐城|Spinach Casino
丙烯醛|Acrolein
丙腈|Propionitrile
丙二酸铊|Thallium malonate
冰妹陪玩|Ice sister keep playing
冰毒提炼教程|Ice refining Tutorials
冰毒技术|Ice Technology
冰毒的制作方法|Methamphetamine production methods
别墅业主信息|Villa owner information
必中特码|Will be the special code
必赢亚洲娱乐城|Asia Entertainment City will win
必胜国际|Win international
苯基甲酮|Phenyl methanone
苯环利定|Phencyclidine
苯丙胺|Amphetamine
苯巴比妥|Phenobarbital
本杰明392|Benjamin 392
奔驰娱乐城|Mercedes Casino
倍它洛尔|Times it lol
保险客户资料|Insurance Customer Information
保险客户数据|Insurance Customer Data
保险客户名录|Insurance Customer List
保险客户名单|Insurance Customer List
保时捷娱乐城|Porsche Casino
保米磷|Paul m phosphorus
保健品数据|Health Data
保健品客户资料|Health care customer data
宝马会娱乐城|BMW would Casino
宝龙娱乐城|Bonhams Entertainment City
半岛国际娱乐城|Peninsula International Casino
办证刻章公司|Rush engraving company
办证公司网|Accreditation company network
办证工作室|Rush studio
佰盈国际|Bai Ying International
百治磷|Dicrotophos
百苑国际娱乐城|One hundred Yuan International Casino
百姓娱乐城|People Casino
百威娱乐城|Budweiser Casino
百胜娱乐城|Yum Casino
百胜百旺|Yum BaiWang
百利宫娱乐城|Paragon Casino
百丽国际娱乐城|Belle Casino
百丽宫娱乐城|Paragon Casino
百乐汇娱乐城|Tupper Casino Meeting
百乐坊娱乐城|Tupper Square Casino
百老汇娱乐城|Broadway Casino
百家乐娱乐城|Baccarat Casino
百家乐平台|Baccarat platform
百家乐开户|Baccarat accounts
百家博娱乐城|One hundred Bo Casino
百分百真票|Hundred percent real votes
百达娱乐城|Pictet Casino
百兵行刀具网|Hundred soldiers line tool network
白砒|White arsenic
白金会娱乐城|Platinum Casino
白金国际娱乐城|Platinum International Casino
白粉妹陪玩|Heroin sister keep playing
巴西娱乐城|Brazil Casino
巴雷特|Barrett
巴克折刀|Buck knife
巴克刀|Buck Knife
巴登娱乐城|Baden Casino
巴比伦娱乐城|Babylon Casino
澳门钻石赌场|Macau Diamond Casino
澳门真人赌博|Macau gambling reality
澳门银河赌场|Galaxy Macau casino
澳门星际赌场|StarWorld Macau casino
澳门网上赌场|Macau Online Casino
澳门莲花娱乐城|Macau Lotus Casino
澳门博彩公司|Macau gaming company
澳门百乐门赌场|Paramount Macau casino
澳大利亚娱乐城|Australian Casino
澳博国际娱乐城|SJM International Casino
铵油炸药|ANFO
铵梯炸药|TNT Explosive
安钠咖|Sodium benzoate
安乐死药物|Euthanasia drug
安乐死毒药|Euthanasia poison
安非他明|Amphetamine
爱赢娱乐城|Love Win Casino
埃托啡|Dhe
阿联酋赌城|UAE Casino
阿昌刀|Achang knife
tt娱乐城|TT Entertainment City
pcp屠龙手|pcp Dragon Hand
pcp秃鹰|pcp vultures
pcp狩猎论坛|PCP Hunting Forum
pcp枪管膛线|PCP rifled barrel
pcp汽枪|pcp air rifle
pcp汽狗|PCP steam Dog
pcp气枪网|PCP airgun Network
pcp气枪|pcp airgun
pcp论坛|pcp Forum
lsd迷幻药|LSD LSD
k粉制作技术|k powder production technology
k粉制作方法|k powder production methods
k7娱乐城|k7 Casino
k7线上娱乐城|K7 Online Casino
jj娱乐城|JJ Entertainment City
ghb原液|GHB dope
ghb水|GHB water
gamo枪|gamo gun
fx气皇|fx gas Wong
fx季候风|fx monsoon
fx革命者|fx revolutionaries
e世博娱乐城|E World Casino
e路发娱乐城|e road Dafa888
diy原子弹教程|DIY tutorial bomb
d80军刺|d80 Shanker
co2狗|CO2 dog
cfx气枪|CFX airgun
ceo娱乐城|ceo Casino
c4橡胶炸药|Rubber C4 explosives
bwin娱乐城|Bwin Casino
bwin亚洲|bwin Asia
betvictor伟德|betvictor Weide
bet365娱乐场|bet365 Casino
bet365|
a8娱乐城|A8 Casino
9点嘻嘻娱乐城|9:00 hee hee Casino
92式手枪|92 pistol
92式手木仓|92 type hand wooden warehouse
92式手狗|92 type hand dog
91娱乐城|91 Casino
88娱乐城|88 Casino
888真人娱乐场|888 Live Casino
7天娱乐城|7 days Casino
77式手狗|77 type hand dog
678娱乐城|678 Casino
654k手枪|654k pistol
654k气枪|654K airgun
64式手木仓|64 type hand wooden warehouse
64式气木仓|64-type air wooden warehouse
56式枪刺|56 bayonet style
56式刺刀|56 bayonet
54式图纸|54-style drawings
54式手木仓|54 type hand wooden warehouse
52名刀网|52 Mito network
45mm铅弹|45MM lead bullets
3d打印枪支图纸|3d printing firearms drawings
21点真钱游戏|21:00 real money games
1比1仿真枪|1 to 1 of imitation guns
12号猎枪|12 shotgun
127名刀网|Mito 127 net
土制炸弹|Homemade bombs
自制炸弹|Homemade bomb
黄牙签|Huang toothpick
盐酸羟亚胺|Hydroxyzine imine
盐酸氯胺酮|Ketamine hydrochloride
天然咖啡因|Natural Caffeine
钻石冰|Diamond Ice
麦角酸|Lysergic acid
麻黄素|Ephedrine
军用弓弩|Military crossbow
77式手枪|77 pistol
54式手枪|Type 54 pistol
自制炸药|Homemade explosives
xx搞zz奖|XX ZZ engage Award
全能神教|Almighty God of
全能教|Almighty taught
qq：260726411|
祝全能神|Good God Almighty
niubwan|
系统 提示|Prompted
打猎专用弩|Special hunting crossbow
係統信息|System Information
咨询兼职加|Plus a part-time consulting
在家兼职|At home part-time
抢单权|Grab one right
信誉保证金|Credit guarantee
至尊职员|Extreme Staff
挂机赚钱|Hook to make money
代付单|Paid on behalf of a single
浏览单|Browse single
垫付单|Single advance
注册单|Registration form
丰彩娱乐|Fung Choi Entertainment
立返单|Li back to a single
手机单|Mobile single
fa lun gong|
fa lun da fa|
三 去 车 仑|Sanqujulun
li hong zhi|
轮功|Falun Gong
毛 泽 东|Mao Zedong
周 恩 来|Zhou Enlai
江 泽 民|Jiang Zemin
胡 锦 涛|Hu Jintao
李 鹏|Li Peng
朱 镕 基|Zhu Rongji
李 岚 清|Li Lanqing
吴 邦 国|Wu Bangguo
温 家 宝|Wen Jiabao
贾 庆 林|Jia Qinglin
曾 庆 红|Zeng Qinghong
黄 菊|Huang Ju
吴 官 正|Wu officer Positive
李 长 春|Li Changchun
罗 干|Luo Gan
法 轮|Falun
李 洪 志|Li Hongzhi
台 独|Taiwan independence
台 湾 独 立|Taiwan independence
江澤民|Jiang Zemin
八老|Eight Elder
反社会|Antisocial
江贼|Jiangzei
巴赫|Bach
台湾政论区|Taiwan Political area
白立朴|Bai Li Pu
方舟子|Fang
江折民|Jiang Min fold
马大维|Mulroney
台湾自由联盟|Taiwan's Freedom Alliance
白梦|Baimeng
飞扬论坛|Flying Forum
江猪|Jiang pig
马良骏|Joshua
斐得勒|Fiji Adler
马三家|Masanjia
汤光中|Light soup
费良勇|Fee Liangyong
江主席|President Jiang
马时敏|Ma Shimin
唐柏桥|Tang Baiqiao
鲍戈|Bao, Ge
分家在|Separation in
姜春云|Chunyun
唐捷|Tang Jie
将则民|Will the people
滕文生|Teng Wensheng
僵贼|Stiff thief
风雨神州|China storm
北大三角地论坛|North Triangle Forum
美国参考|American Reference
北韩|North Korea
北京之春|Beijing Spring
冯素英|Ping Suying
民国|Republic of China
郭罗基|Guo Luoji
钱达|Chanda
郭平|Guo Ping
钱国梁|Qian Guoliang
王冶坪|Wang Yeping
郭岩华|Guo Yanhua
李录|Li Lu
钱其琛|Qian Qichen
国家安全|National Security
尉健行|Wei
国家机密|State secret
乔石|Qiao
国军|Guojun
亲美|Pro-US
魏新生|Wei Xinsheng
大史|Great History
国贼|Traitor
李少民|Li Shaomin
亲日|Pro-Japanese
胡锦滔|Hu Jintao
基督|Christ
江八点|Jiang's eight points
我操|I speak
烂货|Lanhuo
破鞋|Loose woman
album|
address|
antivirus|
bbs|
bookmark|
chat|
default|
demo|
doc|
dos|
download|
faq|
op|
people|
pop|
pop3|
search|
server|
superadmin|
sys|
test|
user|
vip|
virus|
web|
webmastercn|
windows|
51ucadmin|
51ucadministrator|
51ucalbum|
51ucaddress|
51ucantivirus|
51ucbbs|
51ucbj|
51ucbookmark|
51ucceo|
51ucchat|
51ucclub|
51ucclubs|
51ucdefault|
51ucdemo|
51ucdoc|
51ucdos|
51ucdownload|
51ucfaq|
51ucfee|
51ucfinance|
51ucforum|
51ucftp|
51ucgame|
51ucgames|
51ucit|
51ucmail|
51ucmaster|
51ucmember|
51ucnet|
51ucnews|
51ucoffice|
51ucop|
51ucpeople|
51ucpop|
51ucpop3|
51ucsearch|
51ucserver|
51ucsuperadmin|
51ucsys|
51uctest|
51ucuser|
51ucvip|
51ucvirus|
51ucweb|
51ucwebmaster|
51ucwebmastercn|
51ucwindows|
51uc-admin|
51uc-administrator|
51uc-album|
51uc-address|
51uc-antivirus|
51uc-bbs|
51uc-bj|
51uc-bookmark|
51uc-ceo|
51uc-chat|
51uc-club|
51uc-clubs|
51uc-default|
51uc-demo|
51uc-doc|
51uc-dos|
51uc-download|
51uc-faq|
51uc-fee|
51uc-finance|
51uc-forum|
51uc-ftp|
51uc-game|
51uc-games|
51uc-it|
51uc-mail|
51uc-master|
51uc-member|
51uc-net|
51uc-news|
51uc-office|
51uc-op|
51uc-people|
51uc-pop|
51uc-pop3|
51uc-search|
51uc-server|
51uc-superadmin|
51uc-sys|
51uc-test|
51uc-user|
51uc-vip|
51uc-virus|
51uc-web|
51uc-webmaster|
51uc-webmastercn|
51uc-windows|
ucadmin|
ucadministrator|
ucalbum|
ucaddress|
ucantivirus|
ucbbs|
ucbj|
ucbookmark|
ucceo|
ucchat|
ucclub|
ucclubs|
ucdefault|
ucdemo|
ucdoc|
ucdos|
ucdownload|
ucfaq|
ucfee|
ucfinance|
ucforum|
ucftp|
ucgame|
ucgames|
ucit|
ucmail|
ucmaster|
ucmember|
ucnet|
ucnews|
ucoffice|
ucop|
ucpeople|
ucpop|
ucpop3|
ucsearch|
ucserver|
ucsuperadmin|
ucsys|
uctest|
ucuser|
ucvip|
ucvirus|
ucweb|
ucwebmaster|
ucwebmastercn|
ucwindows|
uc-admin|
uc-administrator|
uc-album|
uc-address|
uc-antivirus|
uc-bbs|
uc-bj|
uc-bookmark|
uc-ceo|
uc-chat|
uc-club|
uc-clubs|
uc-default|
uc-demo|
uc-doc|
uc-dos|
uc-download|
uc-faq|
uc-fee|
uc-finance|
uc-forum|
uc-ftp|
uc-game|
uc-games|
uc-it|
uc-mail|
uc-master|
uc-member|
uc-net|
uc-news|
uc-office|
uc-op|
uc-people|
uc-pop|
uc-pop3|
uc-search|
uc-server|
uc-superadmin|
uc-sys|
uc-test|
uc-user|
uc-vip|
uc-virus|
uc-web|
uc-webmaster|
uc-webmastercn|
uc-windows|
令计划|Ling Jihua
主是我心中的歌|The Lord is my heart song
主爱中华我的家|Lord Love China my home
主啊-陶造我|Lord ah - Tao InStyle
耶和华是我牧者|The Lord is my shepherd
耶和华拉法|Jehovah-Rapha
耶和华的精兵|Jehovah's elite
无怨无悔跟主走|Regrets go with main
十字架的呼召|Cross calling
基督徒聚会所|Christian Ashram
复兴耶稣的家|Jesus revival home
唱一首歌中雅歌|Sing a song in the Song of Songs
把耶稣放心里|Jesus assured in
你妈比|Your mother than
你中奖了|You hit the jackpot
我想干你|I wanted you
jj|
bb|
jb|
官商勾结|Collusion
色情小电影|Obscene movies
我日你妈|I Rini Ma
婴儿汤|Baby soup
江猪媳|Jiang pig daughter
肉唇|Rouchun
淫妻|Kinky wife
西藏独立独|Tibet independence alone
反华|Anti-Chinese
反革命|Counterrevolution
淫靡|Yinmi
nihao99|
17043|
